original_firstname	original_lastname	first_name	family_name
TAO	ZHANG	TAO	ZHANG
HAILE	CAI	HAILE	CAI
CHANGZHI	LI	CHANGZHI	LI
AIQIN	WANG	AIQIN	WANG
MARK	GARRETT	MARK	GARRETT
GARY	SHELDRAKE	GARY	SHELDRAKE
JEAN-PAUL	LANGE	JEAN PAUL	LANGE
JEROEN VAN	BUIJTENEN	JEROEN	VAN BUIJTENEN
LETICIA ESPINOSA	ALFONSO	LETICIA	ESPINOSA ALONSO
WOUTER	SPIERING	WOUTER	SPIERING
ROB	POLMANS	ROB	POLMANS
BENJAMIN	KATRYNIOK	BENJAMIN	KATRYNIOK
CARSTEN	LIEBIG	CARSTEN	LIEBIG
CYRILLE	GUILLON	CYRILLE	GUILLON
SÉBASTIEN	PAUL	SEBASTIEN	PAUL
WOLFGANG F	HOELDERICH	WOLFGANG F	HOELDERICH
FRANK	DUMEIGNIL	FRANCK	DUMEIGNIL
MARC	SUTTER	MARC	SUTTER
MARC	LEMAIRE	MARC	LEMAIRE
ESTELLE	METAY	ESTELLE	METAY
YANN	RAOUL	YANN	RAOUL
ALESSANDRO	CHIEREGATO	ALESSANDRO	CHIEREGATO
FRANCESCO	BASILE	FRANCESCO	BASILE
FABRICIO	CAVANI	FABRIZIO	CAVANI
PATRICIA	CONCEPCION	PATRICIA	CONCEPCION
GIUSEPPE	LIOSI	GIUSEPPE	LIOSI
VÉRONIQUE	NARDELLO-RATAJ	VERONIQUE	NARDELLO RATAJ
LOIC	LECLERCQ	LOIC	LECLERCQ
ADRIEN	MOURET	ADRIEN	MOURET
BING	HONG	BING	HONG
ROBERTO	COMPANY	ROBERTO	COMPANY
PIERRE	BAUDUIN	PIERRE	BAUDUIN
ANNA	PROUST	ANNA	PROUST
JEAN-MARIE	AUBRY	JEAN MARIE	AUBRY
WERNER	KUNZ	WERNER	KUNZ
FUWEI	LI	FUWEI	LI
XIA	CHUNGU	XIA	CHUNGU
PEIQING	ZHAO	PEIQING	ZHAO
MAUD	CHEMIN	MAUD	CHEMIN
ANNE-LAURE	WIROTIUS	ANNE LAURE	WIROTIUS
FRÉDÉRIQUE	HAM-PICHAVANT	FREDERIQUE	HAM PICHAVANT
DENILSON DA	SILVA-PEREZ	DENILSON	DA SILVA PEREZ
MICHEL	PETIT-CONIL	MICHEL	PETIT CONIL
GILLES	LABAT	GILLES	LABAT
BENOIT	GADENNE	BENOIT	GADENNE
CARINE	ALFOS	CARINE	ALFOS
HENRI	CRAMAIL	HENRI	CRAMAIL
STÉPHANE	GRELLER	STEPHANE	GRELIER
VALÉRIE	MOLINIER	VALERIE	MOLINIER
AURÉLIE	LAVERGNE	AURELIE	LAVERGNE
LAURIANNE	MOITY	LAURIANNE	MOITY
JONATHAN	LAI	JONATHAN	LAI
MATHIEU	SAUTHIER	MATHIEU	SAUTHIER
ANDRÉ	MORTREUX	ANDRE	MORTREUX
WOUTER	SCHUTYSER	WOUTER	SCHUTYSER
STIJN VAN DE	VYVER	STIJN	VAN DE VYVER
MICHIEL	DUSSELIER	MICHIEL	DUSSELIER
JAN	GEBOERS	JAN	GEBOERS
BERT	SELS	BERT	SELS
DAMIEN	DELCROIX	DAMIEN	DELCROIX
CHRISTOPHE	VALLÉE	CHRISTOPHE	VALLEE
DIDIER	BERNARD	DIDIER	BERNARD
OLIVIA	CHAUMET-MARTIN	OLIVIA	CHAUMET MARTIN
EMMANUELLE	PELLIER	EMMANUELLE	PELLIER
P	CALLEJA	PIERRE	CALLEJA
JOSEPH A	STEWART	JOSEPH A	STEWART
ERIK	REUBSAET	ERIK	REUBSAET
BERT M	WECKHUYSEN	BERT M	WECKHUYSEN
PIETER C A	BRUIJNINCX	PIETER C A	BRUIJNINCX
INAKI	GANDARIAS	INAKI	GANDARIAS
SARA G	FERNANDEZ	SARA G	FERNANDEZ
PEDRO L	ARIAS	PEDRO L	ARIAS
RAJA	ZNAIGUIA	RAJA	ZNAIGUIA
PATRICK	REY	PATRICK	REY
JEAN-MARC	MILLET	JEAN MARC	MILLET
STÉPHANE	LORIDANT	STEPHANE	LORIDANT
PIERRICK	GAUDIN	PIERRICK	GAUDIN
BENDAOU	NOHAIR	BENDAOU	NOHAIR
SERGE	KALIAGUINE	SERGE	KALIAGUINE
MATTHIEU O	SONNATI	MATTHIEU O	SONNATI
SONIA	AMIGONI	SONIA	AMIGONI
ELISABETH P TAFFIN DE	GIVENCHY	ELISABETH	TAFFIN DE GIVENCHY
THIERRY	DARMANIN	THIERRY	DARMANIN
OLIVIER	CHOULET	OLIVIER	CHOULET
FRÉDÉRIC	GUITTARD	FREDERIC	GUITTARD
E	NELHIG	EMILIE	NELHIG
L	MOTTE	LAURENCE	MOTTE
E	GUENIN	ERWANN	GUENIN
HENNING	KAYSER	HENNING	KAYSER
WALTER	LEITNER	WALTER	LEITNER
PABLO DOMINGUEZ DE	MARIA	PABLO	DOMINGUEZ DE MARIA
NATHALIE	TANCHOUX	NATHALIE	TANCHOUX
YULIA	MONAKHOVA	YULIA	MONAKHOVA
PIERRE	AGULHON	PIERRE	AGULHON
DIDIER	TICHIT	DIDIER	TICHIT
FRANÇOISE	QUIGNARD	FRANCOISE	QUIGNARD
GRIT	STRAGANZ	GRIT	STRAGANZ
AGNÈS	ROLLAND-SABATÉ	AGNES	ROLLAND SABATE
ROMAIN	IRAGUE	ROMAIN	IRAGUE
ALAIN	BULÉON	ALAIN	BULEON
LAURENCE	TARQUIS	LAURENCE	TARQUIS
JEAN-LOUIS	DOUBLIER	JEAN LOUIS	DOUBLIER
BERNARD	RIEDL	BERNARD	RIEDL
VAHÉ	VARDANYAN	VAHE	VARDANYAN
ALIREZA	KABOORANI	ALIREZA	KABOORANI
BOUDDAH	POATY	BOUDDAH	POATY
GREGORY	CHAUVE	GREGORY	CHAUVE
ALEXANDRU	CUREA	ALEXANDRU	CUREA
MADALINA	TUDORACHE	MADALINA	TUDORACHE
SIMONA M	COMAN	SIMONA M	COMAN
VASILE	PARVULESCU	VASILE	PARVULESCU
KAMEH	TAJVIDI	KAMEH	TAJVIDI
JENS U	OLTMANNS	JENS U	OLTMANNS
LEILA	NEGAHDAR	LEILA	NEGAHDAR
REGINA	PALKOVITS	REGINA	PALKOVITS
SYLVAIN	CAILLOL	SYLVAIN	CAILLOL
RÉMI	AUVERGNE	REMI	AUVERGNE
BERNARD	BOUTEVIN	BERNARD	BOUTEVIN
NORBERT	STEINFELDT	NORBERT	STEINFELDT
BARAA	SIYO	BARAA	SIYO
JOHAN DE	CONINCK	JOHAN	DE CONINCK
CHRISTOPHE	LUGUEL	CHRISTOPHE	LUGUEL
PETER	MIEDZIAK	PETER	MIEDZIAK
HAMED	ALSHAMMARI	HAMED	ALSHAMMARI
DAVID	WILLOCK	DAVID	WILLOCK
DAVID	KNIGHT	DAVID	KNIGHT
GRAHAM	HUTCHINGS	GRAHAM J	HUTCHINGS
PHILIP	JESSOP	PHILIP	JESSOP
CANDACE	FOWLER	CANDACE	FOWLER
CATHERINE	OÂNEILL	CATHERINE	ONEILL
XIN	SU	XIN	SU
JULIEN	PINAUD	JULIEN	PINAUD
ERICA	KOWAL	ERICA	KOWAL
MICHAEL	CUNNINGHAM	MICHAEL	CUNNINGHAM
YVES	QUENEAU	YVES	QUENEAU
JIA-NENG	TAN	JIA NENG	TAN
MOHAMMED	AHMAR	MOHAMMED	AHMAR
EMELINE	PRANDATO	EMELINE	PRANDATO
FRANÇOISE	MÉCHIN	FRANCOISE	MECHIN
ROBERTO	OLCESE	ROBERTO	OLCESE
BINOD	SHRESTHA	BINOD	SHRESTHA
MOHAMMED	BETTAHAR	MOHAMMED	BETTAHAR
DOMINIQUE	PETITJEAN	DOMINIQUE	PETITJEAN
ANTHONY	DUFOUR	ANTHONY	DUFOUR
CHARLIE	BASSET	CHARLIE	BASSET
SANDRA	CONSTANT	SANDRA	CONSTANT
JEAN-CHARLES	MOTTE	JEAN CHARLES	MOTTE
ABDELATIF	BARAKAT	ABDELLATIF	BARAKAT
CLAIRE	DUMAS	CLAIRE	DUMAS
FRENCESCO DI	RENZO	FRANCESCO	DI RENZO
FRANÇOIS	NAPOLY	FRANCOIS	NAPOLY
BRUNO	ANDRIOLETTI	BRUNO	ANDRIOLETTI
MICHELINE	DRAYE	MICHELINE	DRAYE
LUDIVINE	JEAN-GÉRARD	LUDIVINE	JEAN GERARD
CATHERINE	GOUX-HENRY	CATHERINE	GOUX HENRY
CLAUDIO	AGUIAR	CLAUDIO	AGUIAR
ANTONIO	BAPTISTA	ANTONIO	BAPTISTA
JULIANNA SOUZA	SARTORI	JULIANA	DE SOUZA SARTORI
ALINE	BIGATON	ALINE	BIGATON
TALITA	ZOCCA	TALITA	ZOCCA
MICHELE	CATELAN	MICHELE	CATELAN
NATHALIA	CORREA	NATHALIA	CORREA
FENG	WANG	FENG	WANG
FREDERIC	HAPIOT	FREDERIC	HAPIOT
JEROME	BOULANGER	JEROME	BOULANGER
HERVÉ	BRICOUT	HERVE	BRICOUT
ANNE	PONCHEL	ANNE	PONCHEL
ERIC	MONFLIER	ERIC	MONFLIER
THOMAS	LEBARBÉ	THOMAS	LEBARBE
LISE	MAISONNEUVE	LISE	MAISONNEUVE
SALVADOR	ORDONEZ	SALVADOR	ORDONEZ
EVA	DIAZ	EVA	DIAZ
MATTEO	GUIDOTTI	MATTEO	GUIDOTTI
CRISTINA	TIOZZO	CRISTINA	TIOZZO
RINALDO	PSARO	RINALDO	PSARO
FABIO	CARNIATO	FABIO	CARNIATO
ALESSANDRO	GALLO	ALESSANDRO	GALLO
FRÉDÉRIC	BATAILLE	FREDERIC	BATAILLE
JACQUES	BARBIER	JACQUES	BARBIER
FABIENNE	PERRONA	FABIENNE	PERRONA
ALEXANDRE	BRIAND	ALEXANDRE	BRIAND
ISABELLE	POLAERT	ISABELLE	POLAERT
MARIANA CUNHA	FELIX	MARIANA CUNHA	FELIX
MÉLISSA	FORNASERO	MELISSA	FORNASERO
STÉPHANE	MARCOTTE	STEPHANE	MARCOTTE
LIONEL	ESTEL	LIONEL	ESTEL
RUDY	COVIS	RUDY	COVIS
JUSTINE	GIAUFFRET	JUSTINE	GIAUFFRET
IRENE NOTAR	FRANCESCO	IRENE NOTAR	FRANCESCO
JENNIFER K	EDWARDS	JENNIFER K	EDWARDS
GRAHAM J	HUTCHINGS	GRAHAM J	HUTCHINGS
SYLVAIN	ANTONIOTTI	SYLVAIN	ANTONIOTTI
HARESH	MANYAR	HARESH	MANYAR
CHRISTOPHE	COUTANCEAU	CHRISTOPHE	COUTANCEAU
MATHIEU	MOUGENOT	MATHIEU	MOUGENOT
PASCAL	BRAULT	PASCAL	BRAULT
MARIO	SIMOES	MARIO	SIMOES
STÈVE	BARANTON	STEVE	BARANTON
ERIC DA	SILVA	ERIC	DA SILVA
WISSAM	DAYOUB	WISSAM	DAYOUB
JULIEN	DEBRAY	JULIEN	DEBRAY
GÉRARD	MIGNANI	GERARD	MIGNANI
ARJAN	KLEIJ	ARJAN W	KLEIJ
CHRIS	WHITEOAK	CHRIS	WHITEOAK
FELIU	MASERAS	FELIU	MASERAS
AINARA	NOVA	AINARA	NOVA
PAOLO P	PESCARMONA	PAOLO P	PESCARMONA
SYED M	AL-AMSYAR	SYED M	AL AMSYAR
CHRISTOPHER J	WHITEOAK	CHRISTOPHER J	WHITEOAK
ARJAN W	KLEIJ	ARJAN W	KLEIJ
HICHAM	AITRASS	HICHAM	AIT RASS
NADINE	ESSAYEM	NADINE	ESSAYEM
MICHÈLE	BESSON	MICHELE	BESSON
IRANTZU	SADABA	IRANTZU	SADABA
MANUEL	OJEDA	MANUEL	OJEDA
RAFAEL	MARISCAL	RAFAEL	MARISCAL LOPEZ
MANUEL LOPEZ	GRANADOS	MANUEL	LOPEZ GRANADOS
IKER	AGIRREZABAL-TELLERIA	IKER	AGIRREZABAL TELLERIA
MARTINO	NIEDDU	MARTINO	NIEDDU
ESTELLE	GARNIER	ESTELLE	GARNIER
BERNARD	KUREK	BERNARD	KUREK
FRANCK-DOMINIQUE	VIVIEN	FRANCK DOMINIQUE	VIVIEN
CHRISTOPHE	BLIARD	CHRISTOPHE	BLIARD
ALI	YOUSSEF	ALI	YOUSSEF
JEAN-PIERRE	LLORED	JEAN PIERRE	LLORED
N	FERLIN	NADEGE	FERLIN
S	GATARD	SYLVAIN	GATARD
S	BOUQUILLON	SANDRINE	BOUQUILLON
MASAZUMI	TAMURA	MASAZUMI	TAMURA
KAIYOU	CHEN	KAIYOU	CHEN
YASUSHI	AMADA	YASUSHI	AMADA
YOSHINAO	NAKAGAWA	YOSHINAO	NAKAGAWA
KELLCHI	TOMISHIGE	KEIICHI	TOMISHIGE
SARAVANAMURUGAN	SHUNMUGAVEL	SARAVANAMURUGAN	SHUNMUGAVEL
ANDERS	RIISAGER	ANDERS	RIISAGER
CHRISTOPHE	LEN	CHRISTOPHE	LEN
ESTELLE BANASZAK	LEONARD	ESTELLE	BANASZAK LEONARD
NICOLAS	DRILLAUD	NICOLAS	DRILLAUD
ISABELLE	PEZRON	ISABELLE	PEZRON
HOUCINE	MHEMDI	HOUCINE	MHEMDI
JOHANNES	NIEDERHAUSER	JOHANNES	NIEDERHAUSER
SARAH	PRATTER	SARAH	PRATTER
PRAKASH	SAHOO	PRAKASH	SAHOO
YOUNG-NAM	JANG	YOUNG NAM	JANG
SEUNG-WOO	LEE	SEUNG WOO	LEE
HUIHUI	LIU	HUIHUI	LIU
XIAN	ZHANG	XIAN	ZHANG
GUIYING	LI	GUIYING	LI
CHANGWEI	HU	CHANGWEI	HU
TOMAS VAN	HAASTERECHT	TOMAS	VAN HAASTERECHT
CARL C I	LUDDING	CARL C I	LUDDING
KRIJN P DE	JONG	KRIJN P	DE JONG
JOHANNES H	BITTER	JOHANNES HENDRIK	BITTER
MARGARIDA COSTA	GOMES	MARGARIDA	COSTA GOMES
PASCALE	HUSSON	PASCALE	HUSSON
AGILIO	PADUA	AGILIO	PADUA
KAZUHIKO	ISHIKAWA	KAZUHIKO	ISHIKAWA
MAGDALENA	TITIRICI	MAGDALENA	TITIRICI
ALEKSEY	BYCHKOV	ALEKSEY	BYCHKOV
FREDERIQUE	BERTAUD	FREDERIQUE	BERTAUD
ARNAUD	AUBIGNY	ARNAUD	AUBIGNY
CHRISTELLE	BOUCHERAND	CHRISTELLE	BOUCHERAND
MARIE	BESSIERES	MARIE	BESSIERES
OLIVIER	GUERRINI	OLIVIER	GUERRINI
RÉMI	CAZELLES	REMI	CAZELLES
ANNE	GALARNEAU	ANNE	GALARNEAU
VINCENT	BESSE	VINCENT	BESSE
B	BLAS-MOLINOS	BEATRIZ	BLAS MOLINOS
S	WESSELBAUM	SEBASTIAN	WESSELBAUM
U	HINTERMAIR	ULRICH	HINTERMAIR
G	FRANCIO	GIANCARLO	FRANCIO
W	LEITNER	WALTER	LEITNER
VÉRONIQUE	DUFAUD	VERONIQUE	DUFAUD
BASTIEN	CHATELET	BASTIEN	CHATELET
LIONEL	JOUCLA	LIONEL	JOUCLA
JEAN-PIERRE	DUTASTA	JEAN PIERRE	DUTASTA
ALEXANDRE	MARTINEZ	ALEXANDRE	MARTINEZ
JULIEN	LECLAIRE	JULIEN	LECLAIRE
DANIEL	STELLWAGEN	DANIEL	STELLWAGEN
KRIJN DE	JONG	KRIJN P	DE JONG
JOHANNES	BITTER	JOHANNES HENDRIK	BITTER
AMANDINE	FOULET	AMANDINE	FOULET
HERVÉ	DELEUZE	HERVE	DELEUZE
GUIDO	SONNEMANN	GUIDO	SONNEMANN
PHILIPPE	GARRIGUES	PHILIPPE	GARRIGUES
MARTINE	LARGERON	MARTINE	LARGERON
JOSÉ	FRAILE	JOSE	FRAILE
ENRIQUE	GARCIA-BORDEJÉ	ENRIQUE	GARCIA BORDEJE
LAURA	ROLDAN	LAURA	ROLDAN
FRANCK	LAUNAY	FRANCK	LAUNAY
RITA	SASSINE	RITA	SASSINE
CATARINA	ROCHA	CATARINA	ROCHA
MICHAEL	RAMIN	MICHAEL	RAMIN
THOMAS	ONFROY	THOMAS	ONFROY
ROBERT	GOSSELINK	ROBERT	GOSSELINK
DANIËL	STELLWAGEN	DANIEL	STELLWAGEN
HARRY	BITTER	JOHANNES HENDRIK	BITTER
ANNA	KULIK	ANNA	KULIK
ANGELA	KÖCKRITZ	ANGELA	KOCKRITZ
ANDREAS	MARTIN	ANDREAS	MARTIN
ARNO	BEHR	ARNO	BEHR
PAVEL	HORÁK	PAVEL	HORAK
HYNEK	BENE	HYNEK	BENE
XAVIER	FROGNEUX	XAVIER	FROGNEUX
OLIVIER	JACQUET	OLIVIER	JACQUET
CHRISTOPHE	GOMES	CHRISTOPHE	GOMES
THIBAULT	CANTAT	THIBAULT	CANTAT
MAEVA	GIRAUDO	MAEVA	GIRAUDO
PHILIPPE	BOUCHARD	PHILIPPE	BOUCHARD
WOUTER DE	SOETE	WOUTER	DE SOETE
CAMILLE	LUDOT	CAMILLE	LUDOT
BORIS	ESTRINE	BORIS	ESTRINE
JEAN	LEBRAS	JEAN	LE BRAS
SINISA	MARINKOVIC	SINISA	MARINKOVIC
JACQUES	MUZART	JACQUES	MUZART
JUSSI	RISSANEN	JUSSI	RISSANEN
HENRIK	GRENMAN	HENRIK	GRENMAN
STEFAN	WILLFÖR	STEFAN	WILLFOR
DMITRY	MURZIN	DMITRY	MURZIN
TAPIO	SALMI	TAPIO	SALMI
FLORA T T	NG	FLORA T T	NG
JIN KU	CHO	JIN KU	CHO
KEVIN VAN	GEEM	KEVIN	VAN GEEM
SOPHIE	GUILLAUME	SOPHIE	GUILLAUME
J	BIDANGE	JOHAN	BIDANGE
C	FISCHMEISTER	CEDRIC	FISCHMEISTER
C	BRUNEAU	CHRISTIAN	BRUNEAU
FELIX	RICHTER	FELIX	RICHTER
TIM	KLASEN	TIM	KLASEN
LAILA	SAHRAOUI	LAILA	SAHRAOUI
FERDI	SCHÜTH	FERDI	SCHUTH
MICKA	AGACH	MICKAEL	AGACH
IONNA	MELIDI	IONNA	MELIDI
VÉRONIQUE	RATAJ	VERONIQUE	NARDELLO RATAJ
BOHAN	ZHAO	BOHAN	ZHAO
YAN	ZENG	YAN	ZENG
DONGMEI	TONG	DONGMEI	TONG
LOURDES	BALLINAS-CASARRUBIAS	LOURDES	BALLINAS CASARRUBIAS
TANIA	SAUCEDO	TANIA	SAUCEDO
LAILA	MUNOZ-CASTELLANOS	LAILA	MUNOZ CASTELLANOS
VIRGINIA	NEVAREZ-MOORILLON	VIRGINIA	NEVAREZ MOORILLON
GUILLERMO	GONZALEZ-SANCHEZ	GUILLERMO	GONZALEZ SANCHEZ
OLATUNDE	JOGUNOLA	OLATUNDE	JOGUNOLA
JYRI-PEKKA	MIKKOLA	JYRI PEKKA	MIKKOLA
ISABELLE	CAPRON	ISABELLE	CAPRON
FANCH	CHERHAL	FANCH	CHERHAL
HERVÉ	CATHALA	HERVE	CATHALA
BERNARD	CATHALA	BERNARD	CATHALA
CAPUCINE	DUPONT	CAPUCINE	DUPONT
TIMOTHÉE	NOCQUET	TIMOTHEE	NOCQUET
JEAN-MICHEL	COMMANDRÉ	JEAN MICHEL	COMMANDRE
MAGUELONE	GRATEAU	MAGUELONE	GRATEAU
SYLVAIN	SALVADOR	SYLVAIN	SALVADOR
PURAN SINGH	RATHORE	PURAN SINGH	RATHORE
SONAL	THAKORE	SONAL	THAKORE
FEI	LIU	FEI	LIU
KARINE DE OLIVEIRA	VIGIER	KARINE	DE OLIVEIRA VIGIER
JEAN-MARC	CLACENS	JEAN MARC	CLACENS
FLORYAN	DECAMPO	FLORYAN	DE CAMPO
FRANÇOIS	JÉRÔME	FRANCOIS	JEROME
KÉVIN	LOUIS	KEVIN	LOUIS
LAURENCE	VIVIER	LAURENCE	VIVIER
YANNICK	POUILLOUX	YANNICK	POUILLOUX
JIE	YANG	JIE	YANG
MINGHAO	LI	MINGHAO	LI
BINGHUA	ZHOU	BINGHUA	ZHOU
YANLONG	GU	YANLONG	GU
VERONIKA	FISCHER	VERONIKA	FISCHER
YIN	LIU	YIN	LIU
QINMIN	PAN	QINMIN	PAN
GARRY	REMPEL	GARRY	REMPEL
ANNE	WADOUACHI	ANNE	WADOUACHI
STÉPHANIE	RAT	STEPHANIE	RAT
EMMANUEL	PETIT	EMMANUEL	PETIT
PHILIPPE	MICHAUD	PHILIPPE	MICHAUD
JOSÉ	KOVENSKY	JOSE	KOVENSKY
J	ABDOUL-ZABAR	JULIANE	ABDOUL ZABAR
I	SOREL	ISABELLE	SOREL
V	HÉLAINE	VIRGIL	HELAINE
F	CHARMANTRAY	FRANCK	CHARMANTRAY
T	DEVAMANI	TITU	DEVAMANI
D	YI	DONG	YI
V DE	BERARDINIS	VERONIQUE	DE BERARDINIS
D	LOUIS	DOMINIQUE	LOUIS
P	MARLIÈRE	PHILIPPE	MARLIERE
W -D	FESSNER	WOLF DIETER	FESSNER
L	HECQUET	LAURENCE	HECQUET
LAURENT	ROUMEAS	LAURENT	ROUMEAS
CHAHINEZ	AOUF	CHAHINEZ	AOUF
ERIC	DUBREUCQ	ERIC	DUBREUCQ
HÉLÈNE	FULCRAND	HELENE	FULCRAND
MARKUS	HEINRICH	MARKUS	HEINRICH
CRISTINA DE	SALAS	CRISTINA	DE SALAS
ALICE	MEULLEMIESTRE	ALICE	MEULLEMIESTRE
SID-AHMED	REZZOUG	SID AHMED	REZZOUG
ZOULIKHA	REZZOUG	ZOULIKHA	MAACHE REZZOUG
ALI	ASAFF	ALI	ASAFF
YOLANDA	REYES	YOLANDA	REYES
ANGEL	ACEVES	ANGEL	ACEVES
JUAN CARLOS	MATEOS	JUAN CARLOS	MATEOS
HANA	KRIZOVA	HANA	KRIZOVA
VINCENT	ESCANDE	VINCENT	ESCANDE
CLAUDE	GRISON	CLAUDE	GRISON
DINGYI	YU	DINGYI	YU
YUGEN	ZHANG	YUGEN	ZHANG
ALESSANDRA	VIZZA	ALESSANDRA	VIZZA
JEREMY	JORDA	JEREMY	JORDA
DANIELA	LAVRIC	DANIELA	LAVRIC
JEAN-RENÉ	CHÉROUVRIER	JEAN RENE	CHEROUVRIER
ROMAIN	REY-RODRIGUEZ	ROMAIN	REY RODRIGUEZ
EMILIE	MARIE	EMILIE	MARIE
MARIANNE	GRABER	MARIANNE	GRABER
VALÉRIE	THIÉRIE	VALERIE	THIERY
P	ANASTAS	PAUL T	ANASTAS
J F	MINSTER	JEAN FRANCOIS	MINSTER
B	SELS	BERT	SELS
P	MARION	PHILIPPE	MARION
A	BULEON	ALAIN	BULEON
F	SCHÜTH	FERDI	SCHUTH
M	LERSCH	MARTIN	LERSCH
P	JESSOP	PHILIP	JESSOP
F	AULENTA	FRANCESCA	AULENTA
J	CLARK	JAMES	CLARK
T	ZHANG	TAO	ZHANG
S	REBOUILLAT	SERGE	REBOUILLAT
F DEL	MONTE	FRANCISCO	DEL MONTE
S	KOBAYASHI	SHU	KOBAYASHI
P	MONSAN	PIERRE	MONSAN
S DUPRAT DE	PAULE	SEBASTIEN	DUPRAT DE PAULE
J L	DUBOIS	JEAN LUC	DUBOIS
B	WECKHUYSEN	BERT M	WECKHUYSEN
A	CORMA	AVELINO	CORMA
S	MAURY	SYLVIE	MAURY
M	PHILIPPE	MICHEL	PHILIPPE
C J	LI	CHAO JUN	LI
