original_firstname	original_lastname	first_name	family_name
ZUOWAN	ZHOU	ZUOWAN	ZHOU
LUCIANA	AGOSTINHO	LUCIANA	AGOSTINHO
MARINA	OLIVEIRA	MARINA	OLIVEIRA
MATHEUS	ATTADEMO	MATHEUS	ATTADEMO
PEDRO	ROCHA-FILHO	PEDRO	ROCHA FILHO
CHONG	LI	CHONG	LI
XIAOFENG	YANG	XIAOFENG	YANG
SHI	GAO	SHI	GAO
CAROL SZE KI	LIN	CAROL SZE KI	LIN
NAM HAI	HOANG	NAM HAI	HOANG
TOMOKO	MATSUDA	TOMOKO	MATSUDA
SHUICHI	MORI	SHUICHI	MORI
DEEPAK	PANT	DEEPAK	PANT
SUMAN	BAJRACHARYA	SUMAN	BAJRACHARYA
KAROLIEN	VANBROEKHOVEN	KAROLIEN	VANBROEKHOVEN
HAI	HOANG	NAM HAI	HOANG
CHAHINAZ	KHIAR	CHAHINAZ	KHIAR
TASSADIT	MAZARI	TASSADIT	MAZARI
LEILA	BENNINI	LEILA	BENNINI
MOURAD	HALOUANE	MOURAD	HALOUANE
SALIHA	MENAD	SALIHA	MENAD
FRANÇOIS-XAVIER	FELPIN	FRANCOIS XAVIER	FELPIN
JULIEN	HITCE	JULIEN	HITCE
HENRI	CRAMAIL	HENRI	CRAMAIL
CARLOS	FERNANDEZ	CARLOS	FERNANDEZ
ALAIN	BONNEVILLE	ALAIN	BONNEVILLE
ANDREW	KUPRAT	ANDREW	KUPRAT
TAMAS	VARGA	TAMAS	VARGA
M IAN	CHILDERS	M IAN	CHILDERS
VARUN	GUPTA	VARUN	GUPTA
XIN	SUN	XIN	SUN
TSZ HIM	KWAN	TSZ HIM	KWAN
WEN TAO	TANG	WEN TAO	TANG
KHAI LUN	ONG	KHAI LUN	ONG
ARIFUL	HAQUE MD	MD ARIFUL	HAQUE
SOPHIE	DETERRE	SOPHIE	DETERRE
JONATHAN	MCDONOUGH	JONATHAN	MCDONOUGH
ANH	PHAN	ANH	PHAN
ADAM	HARVEY	ADAM	HARVEY
JOÃO	SANTOS	JOAO	SANTOS
CLÁUDIA	MARTINS	CLAUDIA	MARTINS
JOÃO	COUTINHO	JOAO A P	COUTINHO
SÓNIA	VENTURA	SONIA P M	VENTURA
WENTAO	TANG	WEN TAO	TANG
MD ARIFUL	HAQUE	MD ARIFUL	HAQUE
IGOR	KRYLOV	IGOR	KRYLOV
ALEXANDER	TERENT'EV	ALEXANDER	TERENTEV
VERA	VIL'	VERA	VIL
MATTI	KARP	MATTI	KARP
VILLE	SANTALA	VILLE	SANTALA
RAHUL	MANGAYIL	RAHUL	MANGAYIL
AMANDINE	FLOURAT	AMANDINE	FLOURAT
ABDERRAHIM	REKLA	ABDERRAHIM	REKLA
ANDREIA	TEIXEIRA	ANDREIA	TEIXEIRA
BASTIEN	KAUFFMANN	BASTIEN	KAUFFMANN
TIPHAINE	CLEMENT	TIPHAINE	CLEMENT
FLORENT	ALLAIS	FLORENT	ALLAIS
AUMBER	ABBAS	AUMBER	ABBAS
PRINCE	AMANIAMPONG	PRINCE	AMANIAMPONG
ANA CLÁUDIA	LEITE	ANA CLAUDIA	LEITE
ANA M	FERREIRA	ANA MARIA	FERREIRA
AMINOU	MOHAMADOU	AMINOU	MOHAMADOU
BJARNE	HOLMBOM	BJARNE	HOLMBOM
THOMAS	HOLMBOM	THOMAS	HOLMBOM
JOÃO A P	COUTINHO	JOAO A P	COUTINHO
MARA G	FREIRE	MARA G	FREIRE
ARMANDO J D	SILVESTRE	ARMANDO J D	SILVESTRE
TERESA B V	DINIS	TERESA B V	DINIS
HELENA	PASSOS	HELENA	PASSOS
DIANA L D	LIMA	DIANA L D	LIMA
VALDEMAR I	ESTEVES	VALDEMAR I	ESTEVES
LUÍS	BARBOSA	LUIS	BARBOSA
CATARINA M S S	NEVES	CATARINA M S S	NEVES
AFRODITI	CHATZIFRAGKOU	AFRODITI	CHATZIFRAGKOU
DIMITRIS	CHARALAMPOPOULOS	DIMITRIS	CHARALAMPOPOULOS
NURULAQILAH	MOHD ZAINI	NURUL AQILAH MOHD	ZAINI
LISA	WEIGAND	LISA	WEIGAND
TOM	WELTON	TOM	WELTON
WEI-CHIEN	TU	WEI CHIEN	TU
JASON	HALLETT	JASON	HALLETT
LOUISE	SUMMERTON	LOUISE	SUMMERTON
MOHAMMAD GHITH	AL-SHAAL	MOHAMMAD GHITH	AL SHAAL
MARVIN	METZELAARS	MARVIN	METZELAARS
LAILA	SAHRAOUI	LAILA	SAHRAOUI
REGINA	PALKOVITS	REGINA	PALKOVITS
FERDI	SCHÜTH	FERDI	SCHUTH
ANTOINE	PICCIRILLI	ANTOINE	PICCIRILLI
PHILIPPE	AYRAULT	PHILIPPE	AYRAULT
VINCENT	BONNARME	VINCENT	BONNARME
PHILIPPE	BERTRAND	PHILIPPE	BERTRAND
CLAUDIO	OLDANI	CLAUDIO	OLDANI
BORIS	ESTRINE	BORIS	ESTRINE
SINISA	MARINKOVIC	SINISA	MARINKOVIC
KARINE	DE OLIVEIRA VIGIER	KARINE	DE OLIVEIRA VIGIER
AYMAN	KARAM	AYMAN	KARAM
FRANÇOIS	JÉRÔME	FRANCOIS	JEROME
MATTHEW	CLOUGH	MATTHEW	CLOUGH
ROBERTO	RINALDI	ROBERTO	RINALDI
ANDREAS	VORHOLT	ANDREAS J	VORHOLT
THIEMO	FASSBACH	THIEMO	FASSBACH
TOM	GAIDE	TOM	GAIDE
KADAMBARI	LOKESH	KADAMBARI	LOKESH
CHRIS	WEST	CHRIS	WEST
JOHAN	KUYLENSTIERNA	JOHAN	KUYLENSTIERNA
JIAJUN	FAN	JIAJUN	FAN
VITALIY	BUDARIN	VITALIY	BUDARIN
PETER	PRIECEL	PETER	PRIECEL
FELIPE	CICARONI FERNANDES	FELIPE	CICARONI FERNANDES
PETER R	WILSON	PETER R	WILSON
KERRY	KIRWAN	KERRY	KIRWAN
STUART R	COLES	STUART R	COLES
MARGARIDA	MARTINS	MARGARIDA	MARTINS
ARMANDO	SILVESTRE	ARMANDO J D	SILVESTRE
ULF	PRÜSSE	ULF	PRUESSE
ERIC	WEINGART	ERIC	WEINGART
LINDA	TEEVS	LINDA	TEEVS
CORNELIUS	STAUDE	CORNELIUS	STAUDE
STEFAN	WOLFRUM	STEFAN	WOLFRUM
WERNER	KUNZ	WERNER	KUNZ
ABDALLAH	HAMEL	ABDALLAH	HAMEL
CLARENCE CHARNAY	CHARNAY	CLARENCE CHARNAY	CHARNAY
CARINE	ALFOS	CARINE	ALFOS
RAFFAELE	CUCCINIELLO	RAFFAELE	CUCCINIELLO
MARIA	RICCIARDI	MARIA	RICCIARDI
DANIELE	CESPI	DANIELE	CESPI
FABRIZIO	PASSARINI	FABRIZIO	PASSARINI
JOEL	BARRAULT	JOEL	BARRAULT
CARMINE	CAPACCHIONE	CARMINE	CAPACCHIONE
ANTONIO	PROTO	ANTONIO	PROTO
MICHIEL	DUSSELIER	MICHIEL	DUSSELIER
ANNELIES	DEWAELE	ANNELIES	DEWAELE
RIK	DE CLERCQ	RIK	DE CLERCQ
BERT	SELS	BERT F	SELS
EVELIEN	VANLEEUW	EVELIEN	VANLEEUW
JASPER	VERDUYCKT	JASPER	VERDUYCKT
ROBIN	COECK	ROBIN	COECK
DIRK	DE VOS	DIRK	DE VOS
LÉA	BONNOT	LEA	BONNOT
DONATIEN	GOMES RODRIGUES	DONATIEN	GOMES RODRIGUES
PIERRE	BAUDUIN	PIERRE	BAUDUIN
OPHÉLIE	FADEL	OPHELIE	FADEL
LUC	GIRARD	LUC	GIRARD
ANNABELLE	L'HERMITTE	ANNABELLE	LHERMITTE
ANNE	ROSSIGNOL-CASTERA	ANNE	ROSSIGNOL CASTERA
OLIVIER	DIAT	OLIVIER	DIAT
LAURENT	VANOYE	LAURENT	VANOYE
TAMARA M	SANTOS	TAMARA M	SANTOS
VICTORIA	RIGUAL	VICTORIA	RIGUAL
M VIRGINIA	ALONSO	M VIRGINIA	ALONSO
MERCEDES	OLIET	MERCEDES	OLIET
JUAN C	DOMINGUEZ	JUAN C	DOMINGUEZ
FRANCISCO	RODRIGUEZ	FRANCISCO	RODRIGUEZ
JENNIFER	MACKELLAR	JENNIFER	MACKELLAR
DAVID	CONSTABLE	DAVID J	CHICHESTER CONSTABLE
MARY	KIRCHHOFF	MARY	KIRCHHOFF
CYRIL	PIREZ	CYRIL	PIREZ
WENHAO	FANG	WENHAO	FANG
JEAN-MARC	CLACENS	JEAN MARC	CLACENS
FLORYAN	DE CAMPO	FLORYAN	DE CAMPO
ARMIN	LIEBENS	ARMIN	LIEBENS
MARC	PERA-TITUS	MARC	PERA TITUS
ZHAOJIANG	WANG	ZHAOJIANG	WANG
MENGHUA	QIN	MENGHUA	QIN
YONGCHAO	ZHANG	YONGCHAO	ZHANG
JIAYUN	XU	JIAYUN	XU
ROSENANI	A HAQUE	ROSENANI ANWAEUL	HAQUE
SELIN	VITAS	SELIN	VITAS
TOBIAS	KEPLINGER	TOBIAS	KEPLINGER
ETIENNE	CABANE	ETIENNE	CABANE
SÉBASTIEN	PAUL	SEBASTIEN	PAUL
MÓNICA	JIMÉNEZ-RUIZ	MONICA	JIMENEZ RUIZ
HERVÉ	JOBIC	HERVE	JOBIC
LOUISE	JALOWIECKI-DUHAMEL	LOUISE	JALOWIECKI DUHAMEL
FRANCK	DUMEIGNIL	FRANCK	DUMEIGNIL
MARIELLE	LEMAIRE	MARIELLE	LEMAIRE
VÉRONIQUE	DE BERARDINIS	VERONIQUE	DE BERARDINIS
CHRISTINE	GUÉRARD-HÉLAINE	CHRISTINE	GUERARD HELAINE
VIRGIL	HÉLAINE	VIRGIL	HELAINE
WOLF-DIETER	FESSNER	WOLF DIETER	FESSNER
PERE	CLAPÉS	PERE	CLAPES
MARCEL	SALANOUBAT	MARCEL	SALANOUBAT
MAKSYM	OPANASENKO	MAKSYM	OPANASENKO
MARIYA	SHAMZHY	MARIYA	SHAMZHY
VALERYIA	KASNERYK	VALERYIA	KASNERYK
JIRÍ	CEJKA	JIRI	CEJKA
NICOLAS	NUTTENS	NICOLAS	NUTTENS
DANNY	VERBOEKEND	DANNY	VERBOEKEND
JOOST	VAN AELST	JOOST	VAN AELST
ARON	DENEYER	ARON	DENEYER
TIMUR	DOGU	TIMUR	DOGU
F	MONNET	F	MONNET
R A	GROSS	R A	GROSS
J	HARTWIG	J	HARTWIG
O	KAPPE	C OLIVER	KAPPE
Y	WANG	YE	WANG
P	WASSERCHEID	PETER	WASSERSCHEID
V	BELLIERE-BACA	VIRGINIE	BELLIERE BACA
B	ESTRINE	BORIS	ESTRINE
J	GUILBOT	JEROME	GUILBOT
A	CABIAC	AMANDINE	CABIAC
R	LUQUE	RAFAEL	LUQUE
M	MEIER	MICHAEL A R	MEIER
E	NORRANT	E	NORRANT
N	PATOUILLARD	NORBERT	PATOUILLARD
T	PHAN	TONY	PHAN
GUANG-HUI	WANG	GUANG HUI	WANG
EDWARD	NÜRENBERG	EDWARD	NURENBERG
PIERRE-LUC	DURAND	PIERRE LUC	DURAND
ERWAN	LE GROGNEC	ERWAN	LE GROGNEC
ULIANA	AKHMETZYANOVA	ULIANA	AKHMETZYANOVA
OLEG	KIKHTYANIN	OLEG	KIKHTYANIN
THOMAS	MARIE	THOMAS	MARIE
GAËLLE	WILLIG	GAELLE	WILLIG
JEAN-HUGUES	RENAULT	JEAN HUGUES	RENAULT
EGOR	FUFACHEV	EGOR	FUFACHEV
PIETER	BRUIJNINCX	PIETER C A	BRUIJNINCX
YONGTAEK	LEE	YONGTAEK	LEE
ROBERT	RYCZKOWSKI	ROBERT	RYCZKOWSKI
PIOTR	PRZYBYSZ	PIOTR	PRZYBYSZ
AGNIESZKA M	RUPPERT	AGNIESZKA M	RUPPERT
JACEK	GRAMS	JACEK	GRAMS
CLAUDE	GRISON	CLAUDE	GRISON
VINCENT	ESCANDE	VINCENT	ESCANDE
CYRIL	POULLAIN	CYRIL	POULLAIN
PETER	HESEMANN	PETER	HESEMANN
EDDY	PETIT	EDDY	PETIT
HELENE	MEHEUST	HELENE	MEHEUST
MOHAMED EL HADI	BENHALOUCHE	MOHAMED EL HADI	BENHALOUCHE
ABDELLAH	MILOUDI	ABDELLAH	MILOUDI
STEPHANIE	MAERTEN	STEPHANIE	MAERTEN
FATIMA	EL OUAHABI	FATIMA	EL OUAHABI
ALEXIS	MÉTAIS	ALEXIS	METAIS
JULIAN	KADAR	JULIAN	KADAR
JAKOB	ALBERT	JAKOB	ALBERT
PETER	WASSERSCHEID	PETER	WASSERSCHEID
DIMITRIS	COLLIAS	DIMITRIS	COLLIAS
YUHE	LIAO	YUHE	LIAO
SÉBASTIEN	TILLOY	SEBASTIEN	TILLOY
AURÉLIEN	COCQ	AURELIEN	COCQ
HERVÉ	BRICOUT	HERVE	BRICOUT
CYRIL	ROUSSEAU	CYRIL	ROUSSEAU
ERIC	MONFLIER	ERIC	MONFLIER
RITA	CRAVEIRO	RITA	CRAVEIRO
SUSANA	BARREIROS	SUSANA	BARREIROS
A R D	DUARTE	ANA RITA C	DUARTE
ALEXANDRE	PAIVA	ALEXANDRE	PAIVA
R L	REIS	RUI L	REIS
JUAN ANTONIO	MELERO	JUAN ANTONIO	MELERO
JOSE	IGLESIAS	JOSE	IGLESIAS
CLARA	LOPEZ AGUADO	CLARA	LOPEZ AGUADO
GABRIEL	MORALES	GABRIEL	MORALES
JUAN A	MELERO	JUAN ANTONIO	MELERO
MARTA	PANIAGUA	MARTA	PANIAGUA
JULIEN	ESTAGER	JULIEN	ESTAGER
JESSICA	PLECK	JESSICA	PLECK
JEAN-CHRISTOPHE	MONBALIU	JEAN CHRISTOPHE	MONBALIU
ROMARIC	GERARDY	ROMARIC	GERARDY
LIA	AMARAL	LIA	AMARAL
ASHWIN KUMAR	JAINARAYANAN	ASHWIN KUMAR	JAINARAYANAN
GOMATHI	SHRIDHAR	GOMATHI	SHRIDHAR
SAVITA	LADAGE	SAVITA	LADAGE
LAKSHMY	RAVISHANKAR	LAKSHMY	RAVISHANKAR
FEI	LIU	FEI	LIU
QIAOYUN	LIU	QIAOYUN	LIU
BOTAO	QIAO	BOTAO	QIAO
AIQIN	WANG	AIQIN	WANG
TAO	ZHANG	TAO	ZHANG
NIKOLAUS	SCHWAIGER	NIKOLAUS	SCHWAIGER
KLARA	TREUSCH	KLARA	TREUSCH
ROLAND	NAGL	ROLAND	NAGL
KLAUS	SCHLACKL	KLAUS	SCHLACKL
PETER	PUCHER	PETER	PUCHER
MATTHÄUS	SIEBENHOFER	MATTHAUS	SIEBENHOFER
BERNDT	HAMMERSCHLAG	BERNDT	HAMMERSCHLAG
JULIA	AUSSERLEITNER	JULIA	AUSSERLEITNER
THOMAS	PICHLER	THOMAS	PICHLER
LEILA	MOURA	LEILA	MOURA
JOHN D	HOLBREY	JOHN D	HOLBREY
VIKTORIA	LEITNER	VIKTORIA	LEITNER
LAURA	SPARLINEK	LAURA	SPARLINEK
KATERYNA	WÖSS	KATERYNA	WOSS
CHRISTINE	KLEIN	CHRISTINE	KLEIN
LAURENCE	HECQUET	LAURENCE	HECQUET
FRANCK	CHARMANTRAY	FRANCK	CHARMANTRAY
VÉRONIQUE	DE BERADINIS	VERONIQUE	DE BERARDINIS
THIERRY	GEFFLAUT	THIERRY	GEFFLAUT
EGON	HEUSON	EGON	HEUSON
MAXIME	DE SOUSA	MAXIME	DE SOUSA
MARION	LORILLIERE	MARION	LORILLIERE
JUHA	LINNEKOSKI	JUHA	LINNEKOSKI
MARTTA	ASIKAINEN	MARTTA	ASIKAINEN
ALI	HARLIN	ALI	HARLIN
DAVID	THOMAS	DAVID	THOMAS
MAURIZIO	BENAGLIA	MAURIZIO	BENAGLIA
SIMONA MARGARETA	COMAN	SIMONA MARGARETA	COMAN
MAGDI	BELKASSIM	MAGDI	EL FERGANI
MARIAN	VERZIU	MARIAN	VERZIU
VASILE	PARVULESCU	VASILE	PARVULESCU
CÉCILE	BOUILHAC	CECILE	BOUILHAC
NADIA	HAMMAMI	NADIA	HAMMAMI
MIKE	ROBITZER	MIKE	ROBITZER
JEAN-PIERRE	HABAS	JEAN PIERRE	HABAS
FREE	DE SCHOUWER	FREE	DE SCHOUWER
THOMAS	CUYPERS	THOMAS	CUYPERS
LAURENS	CLAES	LAURENS	CLAES
MICKAËL	HERBAUT	MICKAEL	HERBAUT
GABRIEL	PAËS	GABRIEL	PAES
CARIN	DIETZ	CARIN	DIETZ
MARTIN	VAN SINT ANNALAND	MARTIN	VAN SINT ANNALAND
MAAIKE	KROON	MAAIKE C	KROON
FAUSTO	GALLUCI	FAUSTO	GALLUCCI
FABIO	LORENZINI	FABIO	LORENZINI
ANDREW	MARR	ANDREW C	MARR
YUEMING	WANG	YUEMING	WANG
YUEYUAN	MA	YUEYUAN	MA
XIAOHAN	LIU	XIAOHAN	LIU
MARTIN	REBROS	MARTIN	REBROS
PAUL	ANASTAS	PAUL T	ANASTAS
CHUN	HO LAM	CHUN	HO LAM
MICHAEL	TERHORST	MICHAEL	TERHORST
SALMI	TAPIO	SALMI	TAPIO
ANDREA	NEBREDA	ANDREA	NEBREDA
DMITRY	MURZIN	DMITRY	YU MURZIN
KARI	ERÄNEN	KARI	ERANEN
TAPIO	SALMI	TAPIO	SALMI
HENRIK	GRÉNMAN	HENRIK	GRENMAN
DENIS	LUART	DENIS	LUART
CHRISTOPHE	LEN	CHRISTOPHE	LEN
SOPHIE	BRUNIAUX	SOPHIE	BRUNIAUX
ANNA	SAID STÅLSMEDEN	ANNA	SAID STALSMEDEN
PETTER	DUNÅS	PETTER	DUNAS
AUGUST	RUNEMARK	AUGUST	RUNEMARK
JOSÉ LUIS	BELMONTE VÁZQUEZ	JOSE LUIS	BELMONTE VAZQUEZ
KIM	VAN WEERDENBURG	KIM	VAN WEERDENBURG
REBECCA	RAE	REBECCA	RAE
PER-OLA	NORRBY	PER OLA	NORRBY
NINA	KANN	NINA	KANN
NICOLAS	DUGUET	NICOLAS	DUGUET
ELSA	DERUER	ELSA	DERUER
MARIE-CHRISTINE	DUCLOS	MARIE CHRISTINE	DUCLOS
VALÉRIE	MOLINIER	VALERIE	MOLINIER
JEAN-MARIE	AUBRY	JEAN MARIE	AUBRY
ANDREAS	REDL	ANDREAS	REDL
MARC	LEMAIRE	MARC	LEMAIRE
CHARLOTTE	GOZLAN	CHARLOTTE	GOZLAN
DUC-NAM	VU	DUC NAM	VU
ESTELLE	METAY	ESTELLE	METAY
BORIS	GUICHERET	BORIS	GUICHERET
SOULEYMANE	BAH	SOULEYMANE	BAH
BERNARD	CATHALA	BERNARD	CATHALA
ANA	VILLARES	ANA	VILLARES
CHLOÉ	BENNATI-GRANIER	CHLOE	BENNATI GRANIER
SONA	GARAJOVA	SONA	GARAJOVA
BODO	SAAKE	BODO	SAAKE
XAVIER	FALOURD	XAVIER	FALOURD
CÉLINE	MOREAU	CELINE	MOREAU
LOIC	FOUCAT	LOIC	FOUCAT
JEAN-GUY	BERRIN	JEAN GUY	BERRIN
BIWEN	ZHU	BIWEN	ZHU
DORINE	BELMESSIERI	DORINE	BELMESSIERI
ANNELIES	VANDEKERKHOVE	ANNELIES	VANDEKERKHOVE
CHALACHEW MEBRAHTU	ASMELASH	CHALACHEW ASMELASH	MEBRAHTU
FLORIAN	KREBS	FLORIAN	KREBS
SIGLINDA	PERATHONER	SIGLINDA	PERATHONER
SALVATORE	ABATE	SALVATORE	ABATE
GABRIELE	CENTI	GABRIELE	CENTI
IRINA	DELIDOVICH	IRINA	DELIDOVICH
PETER	DRABO	PETER	DRABO
JULIA	WOHLAND	JULIA	WOHLAND
PIERLUIGI	TOSI	PIERLUIGI	TOSI
JAN KEES	VAN DER WAAL	JAN C KEES	VAN DER WAAL
GERARD	VAN KLINK	GERARD	VAN KLINK
ILONA	VAN ZANDVOORT	ILONA	VAN ZANDVOORT
ED	DE JONG	ED	DE JONG
ALICE	MIJA	ALICE	MIJA
KHALED	KHALILI	KHALED	KHALILI
CHRISTOPHER	LANCEFIELD	CHRISTOPHER	LANCEFIELD
PETER	DE PEINDER	PETER	DE PEINDER
BERT	WECKHUYSEN	BERT M	WECKHUYSEN
JEAN MARIE	AUBRY	JEAN MARIE	AUBRY
BENJAMIN	JOOSEN	BENJAMIN	JOOSEN
IVONNE	RODRIGUEZ-DONIS	IVONNE	RODRIGUEZ DONIS
VINCENT	GERBAUD	VINCENT	GERBAUD
MIKE	ALEXANDRE	MIKE	ALEXANDRE
JEAN-CHRISTOPHE	GARRIGUES	JEAN CHRISTOPHE	GARRIGUES
EMILE	PEREZ	EMILE	PEREZ
COLETTE	LACABANNE	COLETTE	LACABANNE
ERIC	DANTRAS	ERIC	DANTRAS
SOPHIE	FRANCESCHI	SOPHIE	FRANCESCHI
DAMIEN	COUDEYRE	DAMIEN	COUDEYRE
VÂNIA	CASTRO	VANIA	CASTRO
RUI L	REIS	RUI L	REIS
ANA RITA C	DUARTE	ANA RITA C	DUARTE
OANA	DUMITRESCU	OANA	DUMITRESCU
GÉRARD	LINA	GERARD	LINA
MARIA PAULA	ROBALO	MARIA PAULA	ROBALO
ANA CATARINA	SOUSA	ANA CATARINA	SOUSA
M CONCEIÇÃO	OLIVEIRA	M CONCEICAO	OLIVEIRA
LÍGIA	MARTINS	LIGIA O	MARTINS
ABDELKRIM	BERROUKCHE	ABDELKRIM	BERROUKCHE
MOHAMED	TERRAS	MOHAMED	TERRAS
ABDELRAHMANE	LABANI	ABDELRAHMANE	LABANI
IMANE	DENAI	IMANE	DENAI
HAFSA	DELLAOUI	HAFSA	DELLAOUI
WASSILA	LANSARI	WASSILA	LANSARI
SHUNJI	XIE	SHUNJI	XIE
YE	WANG	YE	WANG
XUEJIAO	WU	XUEJIAO	WU
WEIPING	DENG	WEIPING	DENG
QINGHONG	ZHANG	QINGHONG	ZHANG
TAKASHI	OHSHIMA	TAKASHI	OHSHIMA
KAZUHIRO	MORISAKI	KAZUHIRO	MORISAKI
MASANAO	SAWA	MASANAO	SAWA
RYOHEI	YONESAKI	RYOHEI	YONESAKI
YUTA	KONDO	YUTA	KONDO
HIROYUKI	MORIMOTO	HIROYUKI	MORIMOTO
MATTHIAS	KEHRER	MATTHIAS	KEHRER
CATHERINE	PINEL	CATHERINE	PINEL
ACHRAF	SAID	ACHRAF	SAID
DENEILSON	DA SILVA PEREZ	DENILSON	DA SILVA PEREZ
NOEMIE	PERRET	NOEMIE	PERRET
MICHÈLE	BESSON	MICHELE	BESSON
FRÉDÉRIC	HAPIOT	FREDERIC	HAPIOT
THEODORE	VANBESIEN	THEODORE	VANBESIEN
IUNIA	PODOLEAN	IUNIA	PODOLEAN
CRISTINA	RIZESCU	CRISTINA	RIZESCU
CAMELIA	BALA	CAMELIA	BALA
LUCIAN	ROTARIU	LUCIAN	ROTARIU
HERMENEGILDO	GARCIA	HERMENEGILDO	GARCIA
MARIA FRANCISCA	MANO	FRANCISCA	MANO
RUI	L REIS	RUI L	REIS
ANA RITA	DUARTE	ANA RITA C	DUARTE
FEIPING	ZHAO	FEIPING	ZHAO
SILLANPÄÄ	MIKA	SILLANPAA	MIKA
MICHAEL	TAM	MICHAEL	TAM
MATTHIEU	VIROT	MATTHIEU	VIROT
LEILA	NEGAHDAR	LEILA	NEGAHDAR
ARTURO	GONZALEZ-QUIROGA	ARTURO	GONZALEZ QUIROGA
DARIA	OTYUSKAYA	DARIA	OTYUSKAYA
HILAL	TORAMAN	HILAL	TORAMAN
LI	LIU	LI	LIU
JOHANN	JASTRZEBSKI	JOHANN	JASTRZEBSKI
GUY	MARIN	GUY	MARIN
KEVIN	VAN GEEM	KEVIN	VAN GEEM
JORIS	THYBAUT	JORIS	THYBAUT
MARINE	JANVIER	MARINE	JANVIER
ABDUS SAMAD	JAUFURALLY	ABDUS SAMAD	JAUFURALLY
LOUIS	HOLLANDE	LOUIS	HOLLANDE
YIXIAN	CHEN	YIXIAN	CHEN
PAUL-HENRI	DUCROT	PAUL HENRI	DUCROT
ELISE	PINLOCHE	ELISE	PINLOCHE
VÉRONIQUE	AGUIE-BEGHIN	VERONIQUE	AGUIE BEGHIN
EMMANUEL	BERTRAND	EMMANUEL	BERTRAND
STÉPHANIE	BAUMBERGER	STEPHANIE	BAUMBERGER
BERNARD	KUREK	BERNARD	KUREK
LÉA	VILCOCQ	LEA	VILCOCQ
PASCAL	FONGARLAND	PASCAL	FONGARLAND
GUIDO	SONNEMANN	GUIDO	SONNEMANN
HAMZA	ANNATH	HAMZA	ANNATH
GERALD	DONNELLY	GERALD	DONNELLY
PATRICIA	MARR	PATRICIA	MARR
RAINER	SAUERBORN	RAINER	SAUERBORN
FRIEDERIKE	GUTMANN	FRIEDERIKE	GUTMANN
BERND	FRANKE	BERND	FRANKE
MARIA	NILSSON	MARIA	NILSSON
YODI	MAHENDRADHATA	YODI	MAHENDRADHATA
JEAN-CHRISTOPHE	BLIGNY	JEAN CHRISTOPHE	BLIGNY
GUILLAUME	FAYET	GUILLAUME	FAYET
THÉOPHILE	GAUDIN	THEOPHILE	GAUDIN
PATRICIA	ROTUREAU	PATRICIA	ROTUREAU
ISABELLE	PEZRON	ISABELLE	PEZRON
HAIBO	YU	HAIBO	YU
GUILLAUME	POMALAZA	GUILLAUME	POMALAZA
MICKAËL	CAPRON	MICKAEL	CAPRON
MARKUS	HÖLSCHER	MARKUS	HOLSCHER
KAI	ROHMANN	KAI	ROHMANN
WALTER	LEITNER	WALTER	LEITNER
JULIEN	COUVREUR	JULIEN	COUVREUR
AURÉLIEN	PERU	AURELIEN	PERU
PIERRE	FERCHAUD	PIERRE	FERCHAUD
MAXIME	RIVIERE	MAXIME	RIVIERE
AMANDINE	CABIAC	AMANDINE	CABIAC
DAMIEN	DELCROIX	DAMIEN	DELCROIX
NAOKI	MIMURA	NAOKI	MIMURA
NATSUMI	MURAMATSU	NATSUMI	MURAMATSU
OSAMU	SATO	OSAMU	SATO
YOSHIO	MASUDA	YOSHIO	MASUDA
ARITOMO	YAMAGUCHI	ARITOMO	YAMAGUCHI
ANNA KATHARINA	BEINE	ANNA KATHARINA	BEINE
ANREAS J D	KRÜGER	ANDREAS J D	KRUGER
JENS	ARTZ	JENS	ARTZ
PETER J C	HAUSOUL	PETER J C	HAUSOUL
TONY	CHAVE	TONY	CHAVE
ANDRÉS F	SIERRA SALAZAR	ANDRES FELIPE	SIERRA SALAZAR
SERGEY	NIKITENKO	SERGEY I	NIKITENKO
ANDRÉ	AYRAL	ANDRE	AYRAL
VASILE	HULEA	VASILE	HULEA
PATRICIA J	KOOYMAN	PATRICIA J	KOOYMAN
FRANS D	TICHELAAR	FRANS D	TICHELAAR
PATRICK	LACROIX-DESMAZES	PATRICK	LACROIX DESMAZES
JEAN-MARIE	PINCEMIN	JEAN MARIE	PINCEMIN
MARIA NELLY	GARCIA GONZALEZ	MARIA NELLY	GARCIA GONZALEZ
PAOLA	D'ARRIGO	PAOLA	DARRIGO
GIANMARCO	GRIFFINI	GIANMARCO	GRIFFINI
STEFANO	TURRI	STEFANO	TURRI
CHIARA	ALLEGRETTI	CHIARA	ALLEGRETTI
MARINELLA	LEVI	MARINELLA	LEVI
ESTHER	ACHA	ESTHER	ACHA
ION	AGIRRE	ION	AGIRRE
EIDER	ALDALUR	EIDER	ALDALUR
ANA	GÓMEZ	ANA	GOMEZ
SARA	SENDINO	SARA	SENDINO
JOSÉ FRANCISCO	CAMBRA	JOSE FRANCISCO	CAMBRA
VICTORIA LAURA	BARRIO	VICTORIA LAURA	BARRIO
PALOMA	NASCIMENTO	PALOMA	NASCIMENTO
JORGE FERNANDO BRANDÃO	PEREIRA	JORGE FERNANDO BRANDAO	PEREIRA
VALÉRIA DE CARVALHO SANTOS	EBINUMA	SANTOS EBINUMA	VALERIA DE CARVALHO
NOLWENN	TERME	NOLWENN	TERME
ROMAIN	BOULHO	ROMAIN	BOULHO
MELHA	KENDEL	MELHA	KENDEL
JEAN-PHILIPPE	KUCMA	JEAN PHILIPPE	KUCMA
GAËTANE	WIELGOSZ-COLLIN	GAETANE	WIELGOSZ COLLIN
NATHALIE	BOURGOUGNON	NATHALIE	BOURGOUGNON
GILLES	BEDOUX	GILLES	BEDOUX
JENNY	REICHERT	JENNY	REICHERT
KATHARINA	STARK	KATHARINA	STARK
ALEXANDER	TREMEL	ALEXANDER	TREMEL
MANFRED	BALDAUF	MANFRED	BALDAUF
BINGBING	LAI	BINGBING	LAI
YANLONG	GU	YANLONG	GU
SHANG-HAO	LIU	SHANG HAO	LIU
YUN-FEI	LI	YUN FEI	LI
HAN	ZHANG	HAN	ZHANG
WEI-CHENG	LIN	WEI CHENG	LIN
AMRITA	DAS	AMRITA	DAS
TAKUMI	KIMIJIMA	TAKUMI	KIMIJIMA
KENJI	WATANABE	KENJI	WATANABE
MAKOTO	TSUDA	MAKOTO	TSUDA
JOHANNES	SCHÄFFER	JOHANNES	SCHAFFER
MONIKA	ALBER	MONIKA	ALBER
WOLFGANG	KORTH	WOLFGANG	KORTH
MIRZA	COKOJA	MIRZA	COKOJA
ANDREAS	JESS	ANDREAS	JESS
VINICIUS	O O GONÇALVES	VINICIUS OTTONIO OLIVEIRA	GONCALVES
FRÉDÉRIC	RICHARD	FREDERIC	RICHARD
FABIO B	NORONHA	FABIO B	NORONHA
PRISCILLA	M DE SOUZA	PRISCILLA M	DE SOUZA
VICTOR	T DA SILVA	VICTOR T	DA SILVA
CAROLINE	HILLAIRET	CAROLINE	HILLAIRET
JEROME	LE NOTRE	JEROME	LE NOTRE
MARIA ELISABET	PIRES	MARIA ELISABET	PIRES
DAVID	ABAD REMIRO	DAVID	ABAD REMIRO
ALEJANDRO	LEAL DUASO	ALEJANDRO	LEAL DUASO
JOSÉ IGNACIO	GARCÍA LAUREIRO	JOSE IGNACIO	GARCIA LAUREIRO
PASCUAL	PÉREZ	PASCUAL	PEREZ
ABDUL	REHMAN	ABDUL	REHMAN
ANA	LOPEZ	ANA	LOPEZ
ANA	FRANCO	ANA	FRANCO
SUDIPTA	DE	SUDIPTA	DE
ALINA MARIANA	BALU	ALINA MARIANA	BALU
ALFONSO	YEPEZ	ALFONSO	YEPEZ
ANTONIO ANGEL	ROMERO	ANTONIO ANGEL	ROMERO REYES
RAFAEL	LUQUE	RAFAEL	LUQUE
TIMM	LANKAU	TIMM	LANKAU
CHIN-HUI	YU	CHIN HUI	YU
MATILDE VALERIA	SOLMI	MATILDE VALERIA	SOLMI
MARC	SCHMITZ	MARC	SCHMITZ
SILVIA	KLOTZ	SILVIA	KLOTZ
ANJA	KUENZ	ANJA	KUENZ
NAHLA	ARAJI	NAHLA	ARAJI
FRANCOIS	JEROME	FRANCOIS	JEROME
AUDREY	MOORES	AUDREY H	MOORES
GRÉGORY	CHATEL	GREGORY	CHATEL
DESIX	MADJINZA	DESIX DIANE	MADJINZA
BRUNO	PEDRAS	BRUNO	PEDRAS
ISABEL	SÁ-NOGUEIRA	ISABEL	SA NOGUEIRA
PEDRO	SIMÕES	PEDRO	SIMOES
FRÉDÉRIQUE	BERTAUD	FREDERIQUE	BERTAUD
GÉRARD	MORTHA	GERARD	MORTHA
HÉLÈNE	LICHERE	HELENE	LICHERE
LUIS	SERRANO CANTADOR	LUIS	SERRANO CANTADOR
NATHALIE	MARLIN	NATHALIE	MARLIN
SEGOLENE	DE VAUGELADE	SEGOLENE	DE VAUGELADE
EDITH	NICOL	EDITH	NICOL
SVETLANA	VUJOVIC	SVETLANA	VUJOVIC
SOPHIE	BOURCIER	SOPHIE	BOURCIER
STEPHANE	PIRNAY	STEPHANE	PIRNAY
STEPHANE	BOUCHONNET	STEPHANE	BOUCHONNET
DANIEL	TATON	DANIEL	TATON
ETIENNE	GRAU	ETIENNE	GRAU
BLANDINE	TESTUD	BLANDINE	TESTUD
DIDIER	PINTORI	DIDIER	PINTORI
AURELIEN	HERBINSKI	AURELIEN	HERBINSKI
MARC	HERBINSKI	MARC	HERBINSKI
TAWFIQ	NASR ALLAH	TAWFIQ	NASR ALLAH
ANDREW C	MARR	ANDREW C	MARR
HUMZA	IQBAL	HUMZA	IQBAL
JANE	MURRAY	JANE	MURRAY
DANIEL J P	TAVARES	DANIEL J P	TAVARES
LENA CHARLOTTE	OVER	LENA CHARLOTTE	OVER
MICHAEL A R	MEIER	MICHAEL A R	MEIER
JOANA	SILVA	JOANA M	SILVA
RUI	REIS	RUI L	REIS
ANA	DUARTE	ANA RITA C	DUARTE
ANA	GONÇALVES	ANA	GONCALVES
JOANA	PEREIRA	JOANA	PEREIRA
FERNANDO	GONÇALVES	FERNANDO	GONCALVES
ALAIN	LI	ALAIN	LI
CLARA I	HERRERÍAS	CLARA ISABEL	HERRERIAS
JOSÉ M	FRAILE	JOSE MARIA	FRAILE
BEATRIZ	ANGULO	BEATRIZ	ANGULO
ANA	VERA	ANA	VERA
MARIE	FÖLLMER	MARIE	FOLLMER
SIMON	JESTIN	SIMON	JESTIN
WILFRID	NERI	WILFRID	NERI
ALAIN	DERRE	ALAIN	DERRE
CÉLIA	MERCADER	CELIA	MERCADER
PHILIPPE	POULIN	PHILIPPE	POULIN
SVETLANA	KUZNETSOVA	SVETLANA	KUZNETSOVA
BORIS	KUZNETSOV	BORIS	KUZNETSOV
VLADIMIR	LEVNANSKY	VLADIMIR	LEVDANSKY
NATALIA	VASIL'EVA	NATALIA	VASILEVA
ALEXANDER	KAZACHENKO	ALEXANDER	KAZACHENKO
LAURENT	DJAKOVITCH	LAURENT	DJAKOVITCH
CAMILLE	FRANCOIS	CAMILLE	FRANCOIS
SYLVIE	POURCHET	SYLVIE	POURCHET
LAURENT	PLASSERAUD	LAURENT	PLASSERAUD
GILLES	BONI	GILLES	BONI
STÉPHANE	FONTAINE	STEPHANE	FONTAINE
YVES	GAILLARD	YVES	GAILLARD
VINCENT	PLACET	VINCENT	PLACET
SARI	RAUTIAINEN	SARI	RAUTIAINEN
JOSEPH	SAMEC	JOSEPH	SAMEC
LUCIE	FOURNIER	LUCIE	FOURNIER
CARINE	ROBERT	CARINE	ROBERT
CHRISTOPHE M	THOMAS	CHRISTOPHE M	THOMAS
JIA-NENG	TAN	JIA NENG	TAN
YVES	QUENEAU	YVES	QUENEAU
MOHAMMED	AHMAR	MOHAMMED	AHMAR
DELPHINE	MAREK	DELPHINE	MAREK
LEVINH	HOANG	LEVINH	HOANG
LARBI	RHAZI	LARBI	RHAZI
ROBERT	RALAINIRINA	ROBERT	RALAINIRINA
MALEE	KALLBACH	MALEE	KALLBACH
DIANE	BECART	DIANE	BECART
GILLES	GUICHARD	GILLES	GUICHARD
CLAUDIO	PALOMO	CLAUDIO	PALOMO
MASAYUKI	IGUCHI	MASAYUKI	IGUCHI
YUICHIRO	HIMEDA	YUICHIRO	HIMEDA
HAJIME	KAWANAMI	HAJIME	KAWANAMI
MARIE-NOËLLE	ROSSO	MARIE NOELLE	ROSSO
ISABELLE	HERPOËL-GIMBERT	ISABELLE	HERPOEL GIMBERT
ROBERT	RILEY	ROBERT	RILEY
ANAÏS	RANCON	ANAIS	RANCON
SANA	RAOUCHE	SANA	RAOUCHE
IGOR	GRIGORIEV	IGOR	GRIGORIEV
SIMENG	ZHOU	SIMENG	ZHOU
MATTHIEU	HAINAUT	MATTHIEU	HAINAUT
BERNARD	HENRISSAT	BERNARD	HENRISSAT
ELODIE	DRULA	ELODIE	DRULA
LAURENCE	LESAGE-MEESEN	LAURENCE	LESAGE MEESEN
SHINGO	MIYAUCHI	SHINGO	MIYAUCHI
DUC HANH	NGUYEN	DUC HANH	NGUYEN
REGIS	GAUVIN	REGIS	GAUVIN
YOUSSEF	SWESI	YOUSSEF	SWESI
ALAIN	FAVRE-REGUILLON	ALAIN	FAVRE REGUILLON
GUILLAUME	RAFFA	GUILLAUME	RAFFA
JEAN-FRANÇOIS	PAUL	JEAN FRANCOIS	PAUL
HAMIDEH	AMIRFIROUZKOUHI	HAMIDEH	AMIRFIROUZKOUHI
MATTHIAS	ROUCH	MATTHIAS	ROUCH
JOELLE	CHAR	JOELLE	CHAR
NIKLAS	VON WOLFF	NIKLAS	VON WOLFF
THIBAULT	CANTAT	THIBAULT	CANTAT
C OLIVER	KAPPE	C OLIVER	KAPPE
HYE SUNG	YANG	HYE SUNG	YANG
AUDREY	DENICOURT-NOWICKI	AUDREY	DENICOURT NOWICKI
MARIEM	RAUCHDI	MARIEM	RAUCHDI
MUSTAPHA	AIT ALI	MUSTAPHA	AIT ALI
ALAIN	ROUCOUX	ALAIN	ROUCOUX
NICOLA	D'ALESSANDRO	NICOLA	DALESSANDRO
LUCIA	TONUCCI	LUCIA	TONUCCI
MASSIMILIANO	LUPACCHINI	MASSIMILIANO	LUPACCHINI
ANDREA	MASCITTI	ANDREA	MASCITTI
ALESSANDRO	MARRONE	ALESSANDRO	MARRONE
NAZZARENO	RE	NAZZARENO	RE
SANDRA	TAPIN-LINGUA	SANDRA	TAPIN LINGUA
MICHEL	PETIT-CONIL	MICHEL	PETIT CONIL
MATHILDE	MONTIBUS	MATHILDE	MONTIBUS
DENISLON	DA SILVA PEREZ	DENILSON	DA SILVA PEREZ
CHRISTOPHER	HORBACZEWSKYJ	CHRISTOPHER	HORBACZEWSKYJ
PATRICK-KURT	DANNECKER	PATRICK KURT	DANNECKER
URSULA	BIERMANN	URSULA	BIERMANN
JÜRGEN O	METZGER	JURGEN O	METZGER
ANTOINE	GALLOS	ANTOINE	GALLOS
JOHNNY	BEAUGRAND	JOHNNY	BEAUGRAND
GUY	MARLAIR	GUY	MARLAIR
ANITHA	MURALIDHARA	ANITHA	MURALIDHARA
THANGAVELU	JAYABALAN	THANGAVELU	JAYABALAN
KARINE	ADAM	KARINE	ADAM
ARNE	VAN DEN BOSSCHE	ARNE	VAN DEN BOSSCHE
KOEN	BINNEMANS	KOEN	BINNEMANS
WIM	DEHAEN	WIM	DEHAEN
MAXIME	STALPAERT	MAXIME	STALPAERT
SHAOCHEN	HUANG	SHAOCHEN	HUANG
THIERRY	BENVEGNU	THIERRY	BENVEGNU
FREDDY	PESSEL	FREDDY	PESSEL
NOUHA	SARI-SCHMAYSSEM	NOUHA	SARI CHMAYSSEM
SAMIR	TAHA	SAMIR	TAHA
HIBA	MAWLAWI	HIBA	MAWLAWI
JEAN-PAUL	GUEGAN	JEAN PAUL	GUEGAN
LOUISE	RENAULT	LOUISE	RENAULT
VINCENT	FOLLIARD	VINCENT	FOLLIARD
ALINE	AUROUX	ALINE	AUROUX
SIMONA	BENNICI	SIMONA	BENNICI
OTMAN	OTMAN	OTMAN	OTMAN
ALEKSANDRA	LILIC	ALEKSANDRA	LILIC
ISABELLE	FAVIER	ISABELLE	FAVIER
MONTSERRAT	GOMEZ	MONTSERRAT	GOMEZ
TRUNG	DANG BAO	TRUNG	DANG BAO
RENÉ	SAINT-LOUP	RENE	SAINT LOUP
JOVITA	MORENO	JOVITA	MORENO
CARLOS	LIRIO	CARLOS	LIRIO
HARRY	BITTER	JOHANNES HENDRIK	BITTER
JURJEN	SPEKREIJSE	JURJEN	SPEKREIJSE
JEROME	LENOTRE	JEROME	LE NOTRE
JUAN	HOLGUERAS ORTEGA	JUAN	HOLGUERAS ORTEGA
ELINOR	SCOTT	ELINOR	SCOTT
JOHAN	SANDERS	JOHAN	SANDERS
JOSE I	GARCIA	JOSE IGNACIO	GARCIA LAUREIRO
ELISABET	PIRES	MARIA ELISABET	PIRES
EDUARDO	PERALES	EDUARDO	PERALES
BEATRIZ	GINER	BEATRIZ	GINER
LAURA	LOMBA	LAURA	LOMBA
ALEJANDRO	LEAL-DUASO	ALEJANDRO	LEAL DUASO
MARINA	CABALLERO	MARINA	CABALLERO
MANUEL	LOPEZ GRANADOS	MANUEL	LOPEZ GRANADOS
YOLANDA	RODENAS OLALLA	YOLANDA	RODENAS OLAYA
DAVID	MARTIN ALONSO	DAVID	MARTIN ALONSO
RAFAEL	MARISCAL LÓPEZ	RAFAEL	MARISCAL LOPEZ
JAMES A	DUMESIC	JAMES A	DUMESIC
JOHANNES	CLAUSSNITZER	JOHANNES	CLAUSSNITZER
BENJAMIN	BERTLEFF	BENJAMIN	BERTLEFF
KERSTIN	SCHROEDER	KERSTIN	SCHROEDER
ANDERS	RIISAGER	ANDERS	RIISAGER
SANTOSH GOVIND	KHOKARALE	SANTOSH GOVIND	KHOKARALE
SHUNMUGAVEL	SARAVANAMURUGAN	SHUNMUGAVEL	SARAVANAMURUGAN
ESTELLE	ILLOUS	ESTELLE	ILLOUS
JESUS FERMIN	ONTIVEROS	JESUS FERMIN	ONTIVEROS
RAPHAEL	LEBEUF	RAPHAEL	LEBEUF
BINGYU	YANG	BINGYU	YANG
JONATHAN	LAI	JONATHAN	LAI
LOÏC	LECLERCQ	LOIC	LECLERCQ
VÉRONIQUE	NARDELLO-RATAJ	VERONIQUE	NARDELLO RATAJ
JOSE MARÍA	FRAILE	JOSE MARIA	FRAILE
VICENTE	DORADO	VICENTE	DORADO
CLARA ISABEL	HERRERÍAS	CLARA ISABEL	HERRERIAS
AUDREY	LLEVOT	AUDREY	LLEVOT
RONNY	WAHLSTRÖM	RONNY	WAHLSTROM
LAURI	KUUTTI	LAURI	KUUTTI
OUTI	MÄKINEN	OUTI	MAKINEN
HELI	NYGREN	HELI	NYGREN
ATTE	MIKKELSON	ATTE	MIKKELSON
ULLA	HOLOPAINEN-MANTILA	ULLA	HOLOPAINEN MANTILA
DILEK	ERCILI-CURA	DILEK	ERCILI CURA
KATARIINA	ROMMI	KATARIINA	ROMMI
IMANE	IDRIS	IMANE	IDRIS
SEASON	CHEN	SEASON	CHEN
DAN	TSANG	DAN	TSANG
IRIS	YU	IRIS KM	YU
ALEX	YIP	ALEX	YIP
SIMO	KALLIOLA	SIMO	KALLIOLA
EVELIINA	REPO	EVELIINA	REPO
DING	WANG	DING	WANG
ANTOINE	BRUNEAU-VOISINE	ANTOINE	BRUNEAU VOISINE
CHRISTOPHE	DARCEL	CHRISTOPHE	DARCEL
JEAN-BAPTISTE	SORTAIS	JEAN BAPTISTE	SORTAIS
MADALINA	TUDORACHE	MADALINA	TUDORACHE
YASMIN	RAUPP	YASMIN	RAUPP
JONAS	WINTERS	JONAS	WINTERS
GEORGES	DA COSTA	GEORGES	DA COSTA
AGNES	MAGRI	AGNES	MAGRI
JORGE F B	PEREIRA	JORGE FERNANDO BRANDAO	PEREIRA
NATHALIA DE A	SANTOS	NATHALIA DE A	SANTOS
VINCENT	DIEMER	VINCENT	DIEMER
ARNAUD	SALAÜN	ARNAUD	SALAUN
JEAN	LE BIDEAU	JEAN	LE BIDEAU
JAMAL	NAJA	JAMAL	NAJA
RACHID	CHEROUAKI	RACHID	CHEROUAKI
KELLY	SERVAES	KELLY	SERVAES
PIETER	VANDEZANDE	PIETER	VANDEZANDE
STEF	KOELEWIJN	STEVEN FRISO	KOELEWIJN
ANITA	BUEKENHOUDT	ANITA	BUEKENHOUDT
MARCELO E	DOMINE	MARCELO EDUARDO	DOMINE
ALBERTO	FERNÁNDEZ-ARROYO	ALBERTO	FERNANDEZ ARROYO
DANIEL	DELGADO	DANIEL	DELGADO
JOSÉ M	LÓPEZ-NIETO	JOSE MANUEL	LOPEZ NIETO
FRANCESCO	PUZZO	FRANCESCO	PUZZO
FABRIZIO	CAVANI	FABRIZIO	CAVANI
SEBASTIAN	KRICKL	SEBASTIAN	KRICKL
THOMAS	BUCHECKER	THOMAS	BUCHECKER
ROBERT	WINKLER	ROBERT	WINKLER
ISABELLE	GRILLO	ISABELLE	GRILLO
DIDIER	TOURAUD	DIDIER	TOURAUD
ARNO	PFITZNER	ARNO	PFITZNER
BENJAMIN	PACAUD	BENJAMIN	PACAUD
ANNA	PROUST	ANNA	PROUST
HIROAKI	SASAI	HIROAKI	SASAI
MAKOTO	SAKO	MAKOTO	SAKO
SHINOBU	TAKIZAWA	SHINOBU	TAKIZAWA
WON TAE	CHOI	WON TAE	CHOI
DONG WOO	KIM	DONG WOO	KIM
YO HAN	PARK	YO HAN	PARK
YONG SEONG	SEO	YONG SEONG	SEO
KWON TAEK	LIM	KWON TAEK	LIM
ANDRÉ V S	SILVA	ANDRE V S	SILVA
VALÉRIA C S	EBINUMA	SANTOS EBINUMA	VALERIA DE CARVALHO
NICOLAS	BRIDIAU	NICOLAS	BRIDIAU
AMANDINE	ADRIEN	AMANDINE	ADRIEN
ANTOINE	BONNET	ANTOINE	BONNET
DELPHINE	DUFOUR	DELPHINE	DUFOUR
STANISLAS	BAUDOUIN	STANISLAS	BAUDOUIN
THIERRY	MAUGARD	THIERRY	MAUGARD
RICHA	CHAUDHARY	RICHA	CHAUDHARY
PARESH	DHEPE	PARESH	DHEPE
EVELINA	COLACINO	EVELINA	COLACINO
STIJN	RAIGUEL	STIJN	RAIGUEL
DAPHNE	DEPUYDT	DAPHNE	DEPUYDT
DOUNIA	ARCENS	DOUNIA	ARCENS
SARRA	TADRENT	SARRA	TADRENT
ANISSA	KHELFA	ANISSA	KHELFA
OLIVIER	BALS	OLIVIER	BALS
MICHAEL	BROOK	MICHAEL	BROOK
BENJAMIN	MACPHAIL	BENJAMIN	MACPHAIL
LAURA	ZEPEDA-VELAZQUEZ	LAURA	ZEPEDA VELAZQUEZ
TALENA	RAMBARRAN	TALENA	RAMBARRAN
AYODELE	FATONA	AYODELE	FATONA
JOSE	MORAN-MIRABAL	JOSE	MORAN MIRABAL
ROBERT	BUI	ROBERT	BUI
VÉRONIQUE	PERRIER	VERONIQUE	PERRIER
SUZANA	FERREIRA-DIAS	SUZANA	FERREIRA DIAS
CAROLINA	COSTA	CAROLINA	COSTA
JOANA	RODRIGUES	JOANA	RODRIGUES
MAEVA	SUBILEAU	MAEVA	SUBILEAU
ERIC	DUBREUCQ	ERIC	DUBREUCQ
ALBERTO	REIS	ALBERTO	REIS
GUANFENG	LIANG	GUANFENG	LIANG
WANG	AIQIN	WANG	AIQIN
KEVIN	MALONEY	KEVIN	MALONEY
SAÀDIA	CHERIAF	SAIDIA	CHERIEF
SALIMA	MOKHEFI	SALIMA	MOKHEFI
MICKAEL	CAPRON	MICKAEL	CAPRON
ANITA	BOROWIEC	ANITA	BOROWIEC
PARDIS	SIMON	PARDIS	SIMON
MARTINE	TRENTESAUX	MARTINE	TRENTESAUX
JEAN FRANCOIS	DEVAUX	JEAN FRANCOIS	DEVAUX
JEAN LUC	DUBOIS	JEAN LUC	DUBOIS
JEAN FRANÇOIS	PAUL	JEAN FRANCOIS	PAUL
ANNE SOPHIE	MAMEDE	ANNE SOPHIE	MAMEDE
JEAN JACQUES	GALLET	JEAN JACQUES	GALLET
FABRICE	BOURNEL	FABRICE	BOURNEL
NEIL	STROTMAN	NEIL	STROTMAN
ROMAIN	RÉOCREUX	ROMAIN	REOCREUX
CHÉRIF AGHILES	OULD HAMOU	CHERIF AGHILES	OULD HAMOU
CARINE	MICHEL	CARINE	MICHEL
JAVIER B	GIORGI	JAVIER B	GIORGI
PHILIPPE	SAUTET	PHILIPPE	SAUTET
YING-JUNG	CHEN	YING JUNG	CHEN
CHI-MIN SHU	SHU	CHI MIN SHU	SHU
GUOYU	TIAN	GUOYU	TIAN
YINGJUAN	FU	YINGJUAN	FU
PIETER	GEYSENS	PIETER	GEYSENS
JEROEN	SNIEKERS	JEROEN	SNIEKERS
JAN	FRANSAER	JAN	FRANSAER
MARIANNE	GRABER	MARIANNE	GRABER
MARINE	BREITWIESER	MARINE	BREITWIESER
AMELIA	VIRICEL	AMELIA	VIRICEL
VANESSA	BECQUET	VANESSA	BECQUET
CARINE	CHURLAUD	CARINE	CHURLAUD
CAMILLE	LACROIX	CAMILLE	LACROIX
STÉPHANE	LE FLOCH	STEPHANE	LE FLOCH
HÉLÈNE	THOMAS	HELENE	THOMAS GUYON
A	PICCIRILLI	ANTOINE	PICCIRILLI
F	JÉROME	FRANCOIS	JEROME
J-C	DUVAL	J C	DUVAL
M	PHILIPPE	MICHEL	PHILIPPE
J-M	CORPART	J M	CORPART
BERNHARD	STADLER	BERNHARD	STADLER
SANDRA	HINZE	SANDRA	HINZE
HANS	DE VRIES	JOHANNES GERARDUS	DE VRIES
PIM	PUYLAERT	PIM	PUYLAERT
FREDERIQUE	CAUZAC	FREDERIQUE	CAUZAC
VALÉRIE	REYNAUD	VALERIE	REYNAUD
MARLENE	BEYERLE	MARLENE	BEYERLE
THAINÁ S	PECORARI	THAINA S	PECORARI
VALÉRIA C	SANTOS-EBINUMA	SANTOS EBINUMA	VALERIA DE CARVALHO
FRANÇOIS	TÉNÉGAL	FRANCOIS	TENEGAL
SARAH	MOUMEN	SARAH	MOUMEN
R	SHELDON	R	SHELDON
HUGO	GROULT	HUGO	GROULT
JEAN-MARIE	PIOT	JEAN MARIE	PIOT
NICOLAS	POUPARD	NICOLAS	POUPARD
INGRID	FRUITIER-ARNAUDIN	INGRID	FRUITIER ARNAUDIN
SIMON	RAUCH	SIMON	RAUCH
CORNELIS G	VAN DER WIJST	CORNELIS G	VAN DER WIJST
DE	CHEN	DE	CHEN
DUAN	XUEZHI	DUAN	XUEZHI
INGVILD	SKEIE LILAND	INGVILD	SKEIE LILAND
JOHN C	WALMSLAY	JOHN C	WALMSLEY
JUN	ZHU	JUN	ZHU
JOHANNES G	DE VRIES	JOHANNES GERARDUS	DE VRIES
MARC	RENOM-CARRASCO	MARC	RENOM CARRASCO
PIOTR	GAJEWSKI	PIOTR	GAJEWSKI
LAURENT	LEFORT	LAURENT	LEFORT
LUCA	PIGNATARO	LUCA	PIGNATARO
UMBERTO	PIARULLI	UMBERTO	PIARULLI
CESARE	GENNARI	CESARE	GENNARI
CHRISTOPH-MAXIMILIAN	SEIDEL	CHRISTOPH MAXIMILIAN	SEIDEL
THOMAS	PIELHOP	THOMAS	PIELHOP
MICHAEL HANS-PETER	STUDER	MICHAEL HANS PETER	STUDER
PHILIPP	RUDOLF VON ROHR	PHILIPP	RUDOLF VON ROHR
HAO	WANG	HAO	WANG
XU	CHEN	XU	CHEN
DAN	SHU	DAN	SHU
HANBING	WANG	HANBING	WANG
PIERRE	RUTERANA	PIERRE	RUTERANA
PETER A VAN	AKEN	PETER A VAN	AKEN
CHEN	XU	CHEN	XU
GEUN HO	GU	GEUN HO	GU
BENJAMIN	SCHWEITZER	BENJAMIN	SCHWEITZER
DIONISIOS	VLACHOS	DIONISIOS	VLACHOS
STEPHAN	STEINMANN	STEPHAN	STEINMANN
SUELY	PEREIRA FREITAS	SUELY	PEREIRA FREITAS
ELBA	PINTO DA SILVA BON	ELBA	PINTO DA SILVA BON
MARCELLA	FERNANDES SOUZA	MARCELLA	FERNANDES DE SOUZA
FERNANDA	THIMOTEO AZEVEDO JORGE	FERNANDA THIMOTEO AZEVEDO	JORGE
MARCOAURELIO	ALMENARA RODRIGUES	MARCOAURELIO ALMENARA	RODRIGUES
IRIS KM	YU	IRIS KM	YU
MADEEHA	BATOOL	MADEEHA	BATOOL
HUI	SHI	HUI	SHI
ZHAO YU (FLORA)	FAN	ZHAO YU (FLORA)	FAN
BING	HONG	BING	HONG
TIANBO	LI	TIANBO	LI
LALITHA DEVI	GOTTUMUKKALA	LALITHA DEVI	GOTTUMUKKALA
ANNA	SANGREGORIO	ANNA	SANGREGORIO
JAN C	VAN DER WAAL	JAN C KEES	VAN DER WAAL
NATHANAEL	GUIGO	NATHANAEL	GUIGO
NICOLAS	SBIRRAZZUOLI	NICOLAS	SBIRRAZZUOLI
FRANCESCO	DI RENZO	FRANCESCO	DI RENZO
FRANÇOISE	QUIGNARD	FRANCOISE	QUIGNARD
CHARLIE	BASSET	CHARLIE	BASSET
VIVIEN	HENRYON	VIVIEN	HENRYON
JEREMY	LUTERBACHER	JEREMY	LUTERBACHER
CRISTIAN	TORRI	CRISTIAN	TORRI
CHIARA	SAMORÌ	CHIARA	SAMORI
ROBERTO	CONTI	ROBERTO	CONTI
TOM	DETERT OUDE WEME	TOM	DETERT OUDE WEME
WIM	BRILMAN	WIM	BRILMAN
OLGA	FERREIRA	OLGA	FERREIRA
VANESSA	VIEIRA	VANESSA	VIEIRA
JOÃO	A P COUTINHO	JOAO A P	COUTINHO
LILLIAN	BARROS	LILLIAN	BARROS
ISABEL	C F R FERREIRA	ISABEL C F R	FERREIRA
MICHIEL	JANSSEN	MICHIEL	JANSSEN
THOMAS	VOISIN	THOMAS	VOISIN
KOSTAS	TRIANTAFYLLIDIS	KONSTANTINOS	TRIANTAFYLLIDIS
ANGELOS	LAPPAS	ANGELOS	LAPPAS
CHRYSOULA	MICHAILOF	CHRYSOULA	MICHAILOF
ASIMINA	MARIANOU	ASIMINA	MARIANOU
ALINA	NEGOI	ALINA	NEGOI
SIMONA	NEAGU	SIMONA	NEAGU
IOANA	GOMOIU	IOANA	GOMOIU
MADALIN	ENACHE	MADALIN	ENACHE
MOHAMAD FAIZ MUKHTAR	GUNAM RESUL	MOHAMAD FAIZ MUKHTAR	GUNAM RESUL
ANA MARIA	LOPEZ FERNANDEZ	ANA MARIA	LOPEZ FERNANDEZ
MARCELLA	FERNANDES DE SOUZA	MARCELLA	FERNANDES DE SOUZA
AYMAN	EL ROZ	AYMAN	EL ROZ
FRANK	DUMEIGNIL	FRANK	DUMEIGNIL
FAIZ MUKHTAR	GUNAM RESUL	MOHAMAD FAIZ MUKHTAR	GUNAM RESUL
FRANCINE	AGBOSSOU	FRANCINE	AGBOSSOU NIEDERCORN
YANN	CORRE	YANN	CORRE
VINCENT	RYSAK	VINCENT	RYSAK
JEAN-PIERRE	DJUKIC	JEAN PIERRE	DJUKIC
CHRISTOPHE	MICHON	CHRISTOPHE	MICHON
FLÁVIA	VIEIRA	FLAVIA	VIEIRA
ANDREIA	REGO	ANDREIA	REGO
HELENA	ABREU	HELENA	ABREU
CRISTINA	OPRIS	CRISTINA	OPRIS
MIGUEL	ALCALDE	MIGUEL	ALCALDE
MIHAI	IRIMIA-VLADU	MIHAI	IRIMIA VLADU
DIBYENDU	MONDAL	DIBYENDU	MONDAL
MUKESH	SHARMA	MUKESH	SHARMA
MARIA	QUENTAL	MARIA J	QUENTAL
ANA	TAVARES	ANA P M	TAVARES
KAMALESH	PRASAD	KAMALESH	PRASAD
YANNICK	POUILLOUX	YANNICK	POUILLOUX
CRISTIAN	MIRANDA	CRISTIAN	MIRANDA
JULIAN	URRESTA	JULIAN	URRESTA
AMIR	ASTAFAN	AMIR	ASTAFAN
PIERRICK	GAUDIN	PIERRICK	GAUDIN
JEAN	DAOU	JEAN	DAOU
LUDOVIC	PINARD	LUDOVIC	PINARD
CAROLINE	BERENGER	CAROLINE	BERENGER
LUCY C	BROWN	LUCY C	BROWN
GOSIA	SWADZBA-KWASNY	MALGORZATA	SWADZBA KWASNY
JAMES M	HOGG	JAMES M	HOGG
KAROLINA	CHALUPKA	KAROLINA	CHALUPKA
AGNIESZKA	RUPPERT	AGNIESZKA M	RUPPERT
SØREN	TOLBORG	SOREN	TOLBORG
IRANTZU SADABA	ZUBIRI	SADABA ZUBIRI	IRANTZU
SAMUEL	ELLIOT	SAMUEL	ELLIOT
ESBEN	TAARNING	ESBEN	TAARNING
SEBASTIAN	MEIER	SEBASTIAN	MEIER
MICHELINE	DRAYE	MICHELINE	DRAYE
SOPHIE	LETORT	SOPHIE	LETORT
MANUEL	LEJEUNE	MANUEL	LEJEUNE
NATHALIE	KARDOS	NATHALIE	KARDOS
ESTELLE	MÉTAY	ESTELLE	METAY
FLORENCE	POPOWYCZ	FLORENCE	POPOWYCZ
VASILIKI	ZACHAROPOULOU	VASILIKI	ZACHAROPOULOU
ANGELIKI	LEMONIDOU	ANGELIKI	LEMONIDOU
KARIMA	MORAKCHI	KARIMA	MORAKCHI
RAPHAËL	LEBEUF	RAPHAEL	LEBEUF
ERIC	DA SILVA	ERIC	DA SILVA
CORENTIN	DUSSENNE	CORENTIN	DUSSENNE
JAN C KEES	VAN DER WAAL	JAN C KEES	VAN DER WAAL
RONAN	BEHLING	RONAN	BEHLING
SABINE	VALANGE	SABINE	VALANGE
GREGORY	CHATEL	GREGORY	CHATEL
FRANCK	LAUNAY	FRANCK	LAUNAY
SOPHIE	FOURMENTIN	SOPHIE	FOURMENTIN
TAREK	MOUFAWAD	TAREK	MOUFAWAD
MICHEL	FERREIRA	MICHEL	FERREIRA
HERVE	BRICOUT	HERVE	BRICOUT
SEBASTIEN	TILLOY	SEBASTIEN	TILLOY
DAVID	LANDY	DAVID	LANDY
ANA	RIBEIRO	ANA P C	RIBEIRO
ELISABETE C B A	ALEGRIA	ELISABETE C B A	ALEGRIA
LUÍSA M D R S	MARTINS	LUISA M D R S	MARTINS
ARMANDO J L	POMBEIRO	ARMANDO J L	POMBEIRO
ERIC	DEJAIFFE	ERIC	DEJAIFFE
FRANCISCA	MANO	FRANCISCA	MANO
MARGARIDA S	MIRANDA	MARGARIDA S	MIRANDA
LILIANA	RODRIGUES	LILIANA A	RODRIGUES
TERESA	SERRA	TERESA	SERRA
ANA	MATIAS	ANA ALEXANDRA	MATIAS
ANA R	DUARTE	ANA RITA C	DUARTE
PANKAJ	BHARMORIA	PANKAJ	BHARMORIA
YI-HONG	CHUNG	YI HONG	CHUNG
CHI-MIN	SHU	CHI MIN SHU	SHU
WEI-CHUN	CHEN	WEI CHUN	CHEN
YI-WEN	WANG	YIH WEN	WANG
RAFAEL	CARMO	RAFAEL	CARMO
EMANUELLE	FARIA	EMANUELLE L P	FARIA
CARMEN	FREIRE	CARMEN S R	FREIRE
REBECA	SANCHEZ VAZQUEZ	REBECA	SANCHEZ VAZQUEZ
DAVID	BRIONES	DAVID	BRIONES
ANGEL	LOPEZ	ANGEL	LOPEZ
STEVEN-FRISO	KOELEWIJN	STEVEN FRISO	KOELEWIJN
BEGOÑA	GONZÁLEZ	BEGONA	GONZALEZ
PEDRO	MAIRELES-TORRES	PEDRO J	MAIRELES TORRES
CARMEN PILAR	JIMÉNEZ-GÓMEZ	CARMEN PILAR	JIMENEZ GOMEZ
JUAN ANTONIO	CECILIA	JUAN ANTONIO	CECILIA
RAMÓN	MORENO-TOST	RAMON	MORENO TOST
JOSÉ	SANTAMARÍA-GONZÁLEZ	JOSE	SANTAMARIA GONZALEZ
MARTINA	PINI	MARTINA	PINI
ROBERTO	ROSA	ROBERTO	ROSA
PAOLO	NERI	PAOLO	NERI
MASSIMO	CORSI	MASSIMO	CORSI
ROBERTO	BIANCHINI	ROBERTO	BIANCHINI
ANNA MARIA	FERRARI	ANNA MARIA	FERRARI
MARCO	BONANNI	MARCO	BONANNI
JOAO	COUTINHO	JOAO A P	COUTINHO
FILIPA	VICENTE	FILIPA	VICENTE
INES	CARDOSO	INES	CARDOSO
SONIA	VENTURA	SONIA P M	VENTURA
AUDREY	MAZIERE	AUDREY	MAZIERE
ANDRADA	BUTT	ANDRADA	BUT
EVIE	VAN DER WIJST	EVIE	VAN DER WIJST
JENS	NAGENGAST	JENS	NAGENGAST
MARCUS	ROSE	MARCUS	ROSE
ZOE	HEARNE	ZOE	HEARNE
FRANCISCA	SILVA	FRANCISCA A E	SILVA
TANIA	SINTRA	TANIA E	SINTRA
FARID	BENKACI-ALI	FARID	BENKACI ALI
YAMINA	HACIANE	YAMINA	HACIANE
GAUTHIER	EPPE	GAUTHIER	EPPE
LINDA	OTTEN	LINDA	OTTEN
CARMEN	BOERIU	CARMEN	BOERIU
ANAMARIA	TODEA	ANAMARIA	TODEA
ISABEL	ARENDS	ISABEL	ARENDS
FRANCISC	PETER	FRANCISC	PETER
MARIA ANTONIETA	ANAYA CASTRO	MARIA ANTONIETA	ANAYA CASTRO
VANESSA	DURRIEU	VANESSA	DURRIEU
ISABELLE	ALRIC	ISABELLE	ALRIC
SOPHIE	FULLANA-GIROD	SOPHIE	FULLANA GIROD
THIJS	ENNAERT	THIJS	ENNAERT
THAINÁ	PECORARI	THAINA S	PECORARI
VALÉRIA DE C	SANTOS-EBINUMA	SANTOS EBINUMA	VALERIA DE CARVALHO
KATALIN	BARTA	KATALIN	BARTA
MARCIN	JEDRZEJCZYK	MARCIN	JEDRZEJCZYK
OLGA	SNEKA-PLATEK	OLGA	SNEKA PLATEK
KAMILA	KAZMIERCZAK	KAMILA	KAZMIERCZAK
DAMIAN	BROCK	DAMIAN	BROCK
ALI	KHOSHSIMA	ALI	KHOSHSIMA
XAVIER	FROGNEUX	XAVIER	FROGNEUX
PASCALE	CHAMPAGNE	PASCALE	CHAMPAGNE
OMAR	GARCIA-VALDEZ	OMAR	GARCIA VALDEZ
JOAQUIN	ARREDONDO	JOAQUIN	ARREDONDO
PHILIP	JESSOP	PHILIP	JESSOP
MICHAEL	CUNNINGHAM	MICHAEL	CUNNINGHAM
PAOLA	FERRINI	PAOLA	FERRINI
ANDRÉ M	DA COSTA LOPES	ANDRE M	DA COSTA LOPES
RAFAL	LUKASIK	RAFAL	LUKASIK
LUISA	ROSEIRO	LUISA	ROSEIRO
RICARDO	REBELO	RICARDO	REBELO
ENZO	LAURENTI	ENZO	LAURENTI
GIULIANA	MAGNACCA	GIULIANA	MAGNACCA
PIERANGIOLA	BRACCO	PIERANGIOLA	BRACCO
ANDREA	DI GIULIANO	ANDREA	DI GIULIANO
JEREMY	GIRR	JEREMY	GIRR
KATIA	GALLUCCI	KATIA	GALLUCCI
CLAIRE	COURSON	CLAIRE	COURSON
TOMMASO	TABANELLI	TOMMASO	TABANELLI
ALVISE	PEROSA	ALVISE	PEROSA
MAURIZIO	SELVA	MAURIZIO	SELVA
STEFAN	BÖHMDORFER	STEFAN	BOHMDORFER
IVAN	SUMERSKII	IVAN	SUMERSKII
ANTJE	POTTHAST	ANTJE	POTTHAST
GRIGORY	ZINOVYEV	GRIGORY	ZINOVYEV
IRINA	SULAEVA	IRINA	SULAEVA
CHARLIE	VERRIER	CHARLIE	VERRIER
MATTIA	SILVI	MATTIA	SILVI
YANNICK	REY	YANNICK	REY
LUCA	BUZZETTI	LUCA	BUZZETTI
PAOLO	MELCHIORRE	PAOLO	MELCHIORRE
JAIME	GRUNLAN	JAIME	GRUNLAN
MOUSTAFA	KHALIFA	MOUSTAFA	KHALIFA
MOUSTAFA	ABBASSY	MOUSTAFA	ABBASSY
AHMED	MASOUD	AHMED	MASOUD
VINCENT	RITLENG	VINCENT	RITLENG
LOÏC	JIERRY	LOIC	JIERRY
DAVID	EDOUARD	DAVID	EDOUARD
ELODIE	PARDIEU	ELODIE	PARDIEU
NGUYET TRANG THANH	CHAU	NGUYET TRANG THANH	CHAU
LOUIS	LEFEBVRE	LOUIS	LEFEBVRE
JULIEN	KELBER	JULIEN	KELBER
BLANCHE GRAZIELLA	RANISAHARIVONY	BLANCHE GRAZIELLA	RANISAHARIVONY
VOAHANGY	RAMANANDRAIBE	VOAHANGY	VESTALYS RAMANANDRAIBE
PRABHAT	BHAT	PRABHAT	BHAT
WAHIBA	RAMDANI	WAHIBA	RAMDANI
FRANÇOIS	JÉROME	FRANCOIS	JEROME
RACHID	KESSAS	RACHID	KESSAS
ZHIFANG	JIA	ZHIFANG	JIA
LIN	WANG	LIN	WANG
NAOYA	ONISHI	NAOYA	ONISHI
JAMES T	MUCKERMAN	JAMES T	MUCKERMAN
ETSUKO	FUJITA	ETSUKO	FUJITA
YANTAO	WANG	YANTAO	WANG
FREDERIC	DELBECQ	FREDERIC	DELBECQ
RAJENDER	VARMA	RAJENDER	VARMA
STEFANIA	ALBONETTI	STEFANIA	ALBONETTI
LORENZO	GRAZIA	LORENZO	GRAZIA
YU	ZHANG	YU	ZHANG
ALICE	LOLLI	ALICE	LOLLI
GIADA	INNOCENTI	GIADA	INNOCENTI
RIBEIRO	LUCÍLIA	RIBEIRO	LUCILIA
MANUEL FERNANDO R	PEREIRA	MANUEL FERNANDO RIBEIRO	PEREIRA
LUCÍLIA S	RIBEIRO	LUCILIA SOUSA	RIBEIRO
JOSÉ J M	ÓRFÃO	JOSE JOAQUIM DE MELO	ORFAO
CLÉMENT	COMMINGES	CLEMENT	COMMINGES
NIHAT-EGE	SAHIN	NIHAT EGE	SAHIN
ANTHONY	LE VALANT	ANTHONY	LE VALANT
TEKO	NAPPORN	TEKO WILHELMIN	NAPPORN
JULIEN	PARMENTIER	JULIEN	PARMENTIER
OVIDIU	ERSEN	OVIDIU	ERSEN
GEORGIAN	MELINTE	GEORGIAN	MELINTE
BONIFACE	KOKOH	KOUAKOU BONIFACE	KOKOH
BEN	FERINGA	BEN	FERINGA
TAO	YAN	TAO	YAN
FEN-TAIR	LUO	FEN TAIR	LUO
JAROSLAW	POLANSKI	JAROSLAW	POLANSKI
DANILO	BONINCONTRO	DANILO	BONINCONTRO
STEPHANE	GRELIER	STEPHANE	GRELIER
ALEX	RAKOTOVELO	ALEX	RAKOTOVELO
FREDERIC	PERUCH	FREDERIC	PERUCH
CHIN HUI	YU	CHIN HUI	YU
YUHSUAN	LEE	YUHSUAN	LEE
MARIE-CÉLINE	FRANTZ	MARIE CELINE	FRANTZ
ROGER	ROZOT	ROGER	ROZOT
MARIA	DALKO-CSIBA	MARIA	DALKO CSIBA
LAURENCE	DEYON-JUNG	LAURENCE	DEYON JUNG
CHRISTOPHE	MORICE	CHRISTOPHE	MORICE
FLORENCE	CHÉRY	FLORENCE	CHERY
JULIE	GAY	JULIE	GAY
THIERRY	LANGER	THIERRY	LANGER
YVES	GALANTE	YVES	GALANTE
SITI FATAHIYAH	MOHAMAD	SITI FATAHIYAH	MOHAMAD
XAVIER	COQUERET	XAVIER	COQUERET
VERONIQUE	AGUIE	VERONIQUE	AGUIE BEGHIN
SITI	MOHAMAD	SITI FATAHIYAH	MOHAMAD
MICHAEL	MOLINARI	MICHAEL	MOLINARI
CHIARA	SAMORI	CHIARA	SAMORI
PAOLA	GALLETTI	PAOLA	GALLETTI
EMILIO	TAGLIAVINI	EMILIO	TAGLIAVINI
ANKUR	TIWARI	ANKUR	TIWARI
BISWAJIT	CHOWDHURY	BISWAJIT	CHOWDHURY
ADRIANA	FREITES	ADRIANA	FREITES AGUILERA
SHUYANA	HEREDIA	SHUYANA	HEREDIA
PASI	TOLVANEN	PASI	TOLVANEN
SEBASTIEN	LEVENEUR	SEBASTIEN	LEVENEUR
JUN LIU	ZHENG	JUN LIU	ZHENG
TINA	SAMSON	TINA	SAMSON
MARTA	GONZALES MUÑOZ	MARTA	GONZALES MUNOZ
JYRI-PEKKA	MIKKOLA	JYRI PEKKA	MIKKOLA
JOHN	SORENSEN	JOHN	SORENSEN
DAVID	LEVIN	DAVID	LEVIN
MADJID	BIROUK	MADJID	BIROUK
GEUN-HO	HAN	GEUN HO	HAN
KWAN-YOUNG	LEE	KWAN YOUNG	LEE
DAVID	KUBIČKA	DAVID	KUBICKA
SARA	ANDREOLI	SARA	ANDREOLI
GIUSEPPE	FORNASARI	GIUSEPPE	FORNASARI
INAKI	GANDARIAS	INAKI	GANDARIAS
OREGUI-BENGOECHEA	MIKEL	OREGUI BENGOECHEA	MIKEL
MIKEL	OREGUI BENGOECHEA	MIKEL	OREGUI BENGOECHEA
IÑAKI	GANDARIAS	INAKI	GANDARIAS
PEDRO L	ARIAS	PEDRO LUIS	ARIAS
TANJA	BARTH	TANJA	BARTH
XIE	SHUNJI	XIE	SHUNJI
PAN	WANG	PAN	WANG
FLORENT	BOISSOU	FLORENT	BOISSOU
CHRISTOPHE	COUTANCEAU	CHRISTOPHE	COUTANCEAU
STEVE	BARANTON	STEVE	BARANTON
UTE	HENNIGES	UTE	HENNIGES
CHRISTIANE	GOLLNER	CHRISTIANE	GOLLNER
THOMAS	ROSENAU	THOMAS	ROSENAU
LAETITIA	VLAMINCK	LAETITIA	VLAMINCK
KEVIN	DE BRUYCKER	KEVIN	DE BRUYCKER
OGUZ	TÜRÜNÇ	OGUZ	TURUNC
FILIP	DU PREZ	FILIP	DU PREZ
JULIEN	GICQUIAUD	JULIEN	GICQUIAUD
PATRICK	TOULLEC	PATRICK	TOULLEC
PHILIPPE	LOUBET	PHILIPPE	LOUBET
THOMAS	MELINE	THOMAS	MELINE
MURIELLE	MUZARD	MURIELLE	MUZARD
MAGALI	DELEU	MAGALI	DELEU
HARIVONY	RAKOTOARIVONINA	HARIVONY	RAKOTOARIVONINA
RICHARD	PLANTIER ROYON	RICHARD	PLANTIER ROYON
CAROLINE	REMOND	CAROLINE	REMOND
SHENGDONG	WANG	SHENGDONG	WANG
CEDRIC	FISCHMEISTER	CEDRIC	FISCHMEISTER
CHRISTIAN	BRUNEAU	CHRISTIAN	BRUNEAU
SUSANA	RODRIGUEZ COUTO	SUSANA	RODRIGUEZ COUTO
THIERRY	TRON	THIERRY	TRON
ROBERTO	NISTICO'	ROBERTO	NISTICO
MARIA	MARTIN	MARIA	MARTIN
ALESSANDRA	BIANCO PREVOT	ALESSANDRA	BIANCO PREVOT
LUCIANO	CARLOS	LUCIANO	CARLOS
ELENA	ZANZO	ELENA	ZANZO
LUISELLA	CELI	LUISELLA	CELI
EWELINA	KUNA	EWELINA	KUNA
JOSÉ IGNACIO	GARCÍA	JOSE IGNACIO	GARCIA LAUREIRO
ASIER	URRIOLABEITIA	ASIER	URRIOLABEITIA
BRIEUC	LECART	BRIEUC	LECART
HERVÉ	VANDERSCHUREN	HERVE	VANDERSCHUREN
AURORE	RICHEL	AURORE	RICHEL
MOHAMMAD HOSSEIN	RASOULIFARD	MOHAMMAD HOSSEIN	RASOULIFARD
LEILA	GHALAMCHI	LEILA	GHALAMCHI
POONAM	CHOUDHARY	POONAM	CHOUDHARY
ANUSHREE	MALIK	ANUSHREE	MALIK
KAMAL K	PANT	KAMAL KISHORE	PANT
S	REBOUILLAT	SERGE	REBOUILLAT
T	SCHAUB	T	SCHAUB
T	WELTON	TOM	WELTON
D	DE VOS	DIRK	DE VOS
C	HARDACRE	C	HARDACRE
K	WILSON	KAREN	WILSON
DARIUSZ	SWIERCZYNSKI	DARIUSZ	SWIERCZYNSKI
CORINE	GÉRARDIN	CORINE	GERARDIN
NATHALIE	TANCHOUX	NATHALIE	TANCHOUX
JONATHAN FABIAN	SIERRA CANTOR	JONATHAN FABIAN	SIERRA CANTOR
CARLOS-ALBERTO	GUERRERO-FAJARDO	CARLOS ALBERTO	GUERRERO FAJARDO
XAVIER	MARAT	XAVIER	MARAT
SAWANEE	WIKEE	SAOWANEE	WIKEE
FRANÇOIS	PIUMI	FRANCOIS	PIUMI
DANIEL	CULLEN	DANIEL	CULLEN
ERIC	RECORD	ERIC	RECORD
CRAIG B	FAULDS	CRAIG B	FAULDS
MARIANNE	DAOU	MARIANNE	DAOU
ILA	PATEL	ILA	PATEL
ANNE	LOMASCOLO	ANNE	LOMASCOLO
FRÉDÉRIC	LEGER	FREDERIC	LEGER
LAURENT	CÉZARD	LAURENT	CEZARD
SAMIR	MOUSSOUS	SAMIR	MOUSSOUS
ROMAIN	BEAUCHET	ROMAIN	BEAUCHET
CHARLES	KAPPENSTEIN	CHARLES	KAPPENSTEIN
RACHID	BRAHMI	RACHID	BRAHMI
YANN	BATONNEAU	YANN	BATONNEAU
PIERRE	CHABERNAUD	PIERRE	CHABERNAUD
ZAKI	EL SAYAH	ZAKI	EL SAYAH
CORENTIN	MALEIX	CORENTIN	MALEIX
XAVIER	SECORDEL	XAVIER	SECORDEL
LUIGI	VACCARO	LUIGI	VACCARO
IMANE	SEMHAOUI	IMANE	SEMHAOUI
CARLO	SANTULLI	CARLO	SANTULLI
TERESA	CECCHI	TERESA	CECCHI
MARTINA	CECCHI	MARTINA	CECCHI
JOSE A	LOPEZ-SANCHEZ	JOSE ANTONIO	LOPEZ SANCHEZ
NOR AZAM	ENDOT	NOR AZAM	ENDOT
NICHOLAS	GREEVES	NICHOLAS	GREEVES
DAVID	GUIEYSSE	DAVID	GUIEYSSE
SHU	KOBAYASHI	SHU	KOBAYASHI
ARTUR M S	SILVA	ARTUR M S	SILVA
ANA	FERNANDES	ANA M	FERNANDES
DAVID	KUBICKA	DAVID	KUBICKA
HAKIMA	EL KNIDRI	HAKIMA	EL KNIDRI
REDOUANE	EL KHALFAOUY	REDOUANE	EL KHALFAOUY
RAJAE	BELAABED	RAJA	BELAABED
ALI	LAAJEB	ALI	LAAJEB
AHMED	LAHSINI	AHMED	LAHSINI
ABDELLAH	ADDAOU	ABDELLAH	ADDAOU
ALI	BASHAL	ALI	BASHAL
NICK	GREEVES	NICK	GREEVES
JOSE	LOPEZ-SANCHEZ	JOSE ANTONIO	LOPEZ SANCHEZ
MOHAMED KHEIREDDINE	AROUA	MOHAMED KHEIREDDINE	AROUA
WAN MOHD ASHRI WAN	DAUD	WAN MOHD ASHRI WAN	DAUD
PEI-SAN	KONG	PEI SAN	KONG
PATRICK	COGNET	PATRICK	COGNET
YOLANDE	PERES	YOLANDE	PERES LUCCHESE
SHAHLA	SHAHRIARI	SHAHLA	SHAHRIARI
JESUS	LEMUS	JESUS	LEMUS
CATHERINE	BATIOT-DUPEYRAT	CATHERINE	BATIOT DUPEYRAT
J F	GELVES	JOHN FREDDY	GELVES DIAZ
GERMÁN	SIERRA GALLEGO	GERMAN	SIERRA GALLEGO
DOMINIQUE	BENAZET	DOMINIQUE	BENAZET
PETER	SCHREINER	PETER	SCHREINER
SYLVAIL	CAILLOL	SYLVAIN	CAILLOL
MARINE	BLAIN	MARINE	BLAIN
BRUNO	ANDRIOLETTI	BRUNO	ANDRIOLETTI
LUDIVINE	JEAN-GÉRARD	LUDIVINE	JEAN GERARD
RÉMY	AUVERGNE	REMI	AUVERGNE
GISELY	VIEIRA	GISELY	VIEIRA
MARIANE	VERGILIO	MARIANE	VERGILIO
PEDRO	ROCHA FILHO	PEDRO	ROCHA FILHO
KAZUHIKO	ISHIKAWA	KAZUHIKO	ISHIKAWA
JULIA	SCHÜCKEL	JULIA	SCHUCKEL
ANTONIO	ARQUES	ANTONIO	ARQUES
LUISA	MARTINS	LUISA M D R S	MARTINS
ARMANDO	POMBEIRO	ARMANDO J L	POMBEIRO
LIQAA	MAJDAL	LIQAA	MAJDAL
JOSE ANTONIO	LOPEZ-SANCHEZ	JOSE ANTONIO	LOPEZ SANCHEZ
ADOLFO	HENRÍQUEZ	ADOLFO	HENRIQUEZ
DAVID	CONTRERAS	DAVID	CONTRERAS
HÉCTOR	MANSILLA	HECTOR	MANSILLA
AZAEL	MARTÍNEZ-DE LA CRUZ	AZAEL	MARTINEZ DE LA CRUZ
ANNE	MANDEAU	ANNE	MANDEAU
VALERIE	TEYSSEYRE	VALERIE	TEYSSEYRE
LAURENT	SUBRA	LAURENT	SUBRA
VINCENT	DOUAY	VINCENT	DOUAY
MARIE	MORARD	MARIE	MORARD
DAVID	LAMOLINAIRIE	DAVID	LAMOLINAIRIE
JEAN-MARIE	AUTRET	JEAN MARIE	AUTRET
BERNARD	FABRE	BERNARD	FABRE
RADIA	LEMOUCHI	RADIA	LEMOUCHI
JAMIE	WALTERS	JAMIE	WALTERS
HAIWEI	GUO	HAIWEI	GUO
NICHOLAS	WESTWOOD	NICHOLAS	WESTWOOD
VOAHANGY	VESTALYS RAMANANDRAIBE	VOAHANGY	VESTALYS RAMANANDRAIBE
ANDRIANARIVO IRENE	RAHOBINIRINA	ANDRIANARIVO IRENE	RAHOBINIRINA
MICHAELE	RANARIJAONA	MIARINTSOA MICHAELE	RANARIJAONA
ELISABETE	ALEGRIA	ELISABETE C B A	ALEGRIA
ANA P C	RIBEIRO	ANA P C	RIBEIRO
EMMANUELE	FONTOLAN	EMMANUELE	FONTOLAN
ROBERTA	BERTANI	ROBERTA	BERTANI
MOHAMED	SOLIMAN	MOHAMED	SOLIMAN
MARTA	SARAIVA	MARTA	SARAIVA
ANA	CLAUDIO	ANA FILIPA M	CLAUDIO
SELESA	SHABUDIN	SELESA	SHABUDIN
MONICA	VALEGA	MONICA	VALEGA
FERNANDO	DOMINGUES	FERNANDO M J	DOMINGUES
MARA	FREIRE	MARA G	FREIRE
ADRIEN	MONTAGUT-ROMANS	ADRIEN	MONTAGUT ROMANS
MARIE-AUDE	HIEBEL	MARIE AUDE	HIEBEL
PIERRE	LAFITE	PIERRE	LAFITE
HICHEM	HENCHIRI	HICHEM	HENCHIRI
FLORENT	YVERGNAUX	FLORENT	YVERGNAUX
PATRICE	ANDRE	PATRICE	ANDRE
CLAIRE	ELFAKIR	CLAIRE	ELFAKIR
EMILIE	DESTANDAU	EMILIE	DESTANDAU
BLERINA	GJOKA	BLERINA	GJOKA
RICHARD	HEYN	RICHARD	HEYN
STEPHANE	SOUM	STEPHANE	SOUM
STEFANO	LANGE	STEFANO	LANGE
MARC-OLIVIER	SIMON	MARC OLIVIER	SIMON
KILIAN	KOBL	KILIAN	KOBL
ROGER-MARC	NICOUD	ROGER MARC	NICOUD
MARIA	FUENTES CAMPOS	MARIA	FUENTES CAMPOS
IL-SHIK	MOON	IL SHIK	MOON
GOVINDAN	MUTHURAMAN	GOVINDAN	MUTHURAMAN
BALAJI	SUBRAMANIAM	BALAJI	SUBRAMANIAM
AKIYOSHI	OKAFUJI	AKIYOSHI	OKAFUJI
HIROYUKI	OHNO	HIROYUKI	OHNO
MAXIM	KUZNETSOV	MAXIM	KUZNETSOV
JIAWEI	WANG	JIAWEI	WANG
SÓNIA	CARABINEIRO	SONIA	CARABINEIRO
EMILIE	SINGER	EMILIE	SINGER
JULIANA	VELASQUEZ OCHOA	JULIANA	VELASQUEZ OCHOA
CRISTIANA	CESARI	CRISTIANA	CESARI
RITA	MAZZONI	RITA	MAZZONI
CARLO	LUCARELLI	CARLO	LUCARELLI
VALERIO	ZANOTTI	VALERIO	ZANOTTI
PIERRE	WARNAULT	PIERRE	WARNAULT
ALI	NEMATI KHARAT	ALI	NEMATI KHARAT
ISABELLE	JACQUES	ISABELLE	JACQUES
MIREILLE	MOUTIEZ	MIREILLE	MOUTIEZ
PASCAL	BELIN	PASCAL	BELIN
JERZY	WITWINOWSKI	JERZY	WITWINOWSKI
JÉRÔME	SEGUIN	JEROME	SEGUIN
EMMANUEL	FAVRY	EMMANUEL	FAVRY
ROBERT	THAI	ROBERT	THAI
JEAN-LUC	PERNODET	JEAN LUC	PERNODET
MURIEL	GONDRY	MURIEL	GONDRY
KANNAN	KARUNAKARAN	KANNAN	KARUNAKARAN
NADIA	EL OUAHEDY	NADIA	EL OUAHEDY
LAURENCE	PIRAULT-ROY	LAURENCE	PIRAULT ROY
IRANTZU	SADABA	SADABA ZUBIRI	IRANTZU
ROBERTO	CALMANTI	ROBERTO	CALMANTI
PIERRE	BADUIN	PIERRE	BAUDUIN
HERVE	DAVID	HERVE	DAVID
SIMON	TROUILLE	SIMON	TROUILLE
JINZHU	XU	JINZHU	XU
MARION	GABANT	MARION	GABANT
HELENE	MERCAT	HELENE	MERCAT
AUDREY	CARREAUD	AUDREY	CARREAUD
PRISCILLA	RIVA	PRISCILLA	RIVA
KARINE	PICOLET	KARINE	PICOLET
ANNABELLE	EUDELINE-LY	ANNABELLE	EUDELINE LY
JEROME	GOMAR	JEROME	GOMAR
GWENAELLE	JEGOU	GWENAELLE	JEGOU
DELPHINE	MOULIN	DELPHINE	MOULIN
ADAM GOPAL	RAMU	ADAM GOPAL	RAMU
BENOIT	KARTHEUSER	BENOIT	KARTHEUSER
FRANÇOIS	COLLIGNON	FRANCOIS	COLLIGNON
STEFAN	CHASSAING	STEFAN	CHASSAING
TONY	GARNIER	TONY	GARNIER
MATHIEU	DANEL	MATHIEU	DANEL
PATRICK	PALE	PATRICK	PALE
JENI	TOLAND	JENI	TOLAND
JOHN	HOLBREY	JOHN D	HOLBREY
MARTIN	ATKINS	MARTIN	ATKINS
JORGE	PEREIRA	JORGE FERNANDO BRANDAO	PEREIRA
FRANZISKA	AUER	FRANZISKA	AUER
EPPE	GAUTHIER	EPPE	GAUTHIER
MARCELLA	IANNUZZI	MARCELLA	IANNUZZI
CODY	GALE	CODY	GALE
BRANDON	CHIN	BRANDON	CHIN
DANIEL	GRAIVER	DANIEL	GRAIVER
JACQUES	L'HARIDON	JACQUES	LHARIDON
MICHEL	PHILIPPE	MICHEL	PHILIPPE
PATRICIA	MARTZ	PATRICIA	MARTZ
KATHARINA	HÄCKL	KATHARINA	HACKL
OLNDA	GIMELLO	OLINDA	GIMELLO
ATIF EMRE	DEMET	ATIF EMRE	DEMET
ROSSELLA	ARLETTI	ROSSELLA	ARLETTI
URSKA	MOHORIC	URSKA	MOHORIC
ANDREA	BEUTNER	ANDREA	BEUTNER
ANDREAS	MEYER	ANDREAS	MEYER
FRANK-MICHAEL	MATYSIK	FRANK MICHAEL	MATYSIK
BURKHARD	KÖNIG	BURKHARD	KONIG
LAXMAN	SINGH	LAXMAN	SINGH
IQRA ZUBAIR	AWAN	IQRA ZUBAIR	AWAN
FRANCOISE	QUIGNARD	FRANCOISE	QUIGNARD
RACHEDI	YAHIA	RACHEDI	YAHIA
BEN MOHAMED	SOUMAYA	BEN MOHAMED	SOUMAYA
MAAMAR	HAMDI	MAAMAR	HAMDI
FRANÇOISE	DUMAS	FRANCOISE	DUMAS
SARA	BAPTISTA	SARA	BAPTISTA
LÍGIA O	MARTINS	LIGIA O	MARTINS
ELENA	TOMMASI	ELENA	TOMMASI
GIORGIO	GRILLO	GIORGIO	GRILLO
GIANCARLO	CRAVOTTO	GIANCARLO	CRAVOTTO
MASSIMO	TACCHINI	MASSIMO	TACCHINI
MATILDE	MAZZOTTI	MATILDE	MAZZOTTI
SILVIA	TABASSO	SILVIA	TABASSO
MATHIEU	LETI	MATHIEU	LETI
MARION	SERVANGE	MARION	SERVANGE
JEROME	GUILBOT	JEROME	GUILBOT
SÉBASTIEN	DUPRAT DE PAULE	SEBASTIEN	DUPRAT DE PAULE
LAYLA	FILICIOTTO	LAYLA	FILICIOTTO
ALI	NEMMATI KHARAT	ALI	NEMATI KHARAT
IRENE	TOSI	IRENE	TOSI
ELISABETH	SJÖHOLM	ELISABETH	SJOHOLM
PER	TÖRNGREN	PER	TORNGREN
JERK	RÖNNOLS	JERK	RONNOLS
RALUCA	NASTASE	RALUCA	NASTASE
ISABELLE	CAPRON	ISABELLE	CAPRON
ELODIE	FOURRÉ	ELODIE	FOURRE
OXANA	TARAN	OXANA	TARAN
NIKOLAY	GROMOV	NIKOLAY	GROMOV
PAVEL	KOLINKO	PAVEL	KOLINKO
CYRIL	AYMONIER	CYRIL	AYMONIER
SERENA	RIGHI	SERENA	RIGHI
LUCIANO	VOGLI	LUCIANO	VOGLI
SEONG SOO	HONG	SEONG SOO	HONG
MINH QUOC CUONG	LE	MINH QUOC CUONG	LE
SUVI-KATRIINA	RUOKONEN	SUVI KATRIINA	RUOKONEN
SUSANNE	WIEDMER	SUSANNE	WIEDMER
MARIA	SUNDVIK	MARIA	SUNDVIK
ALISTAIR	KING	ALISTAIR	KING
PERTTI	PANULA	PERTTI	PANULA
JALEL	LABIDI	JALEL	LABIDI
XABIER	ERDOCIA	XABIER	ERDOCIA
JAVIER	FERNÁNDEZ-RODRÍGUEZ	JAVIER	FERNANDEZ RODRIGUEZ
MARIA	GONZALEZ ALRIOLS	MARIA	GONZALEZ ALRIOLS
ANE	SEQUEIROS	ANE	SEQUEIROS
NATALIA	POTRZEBOWSKA	NATALIA	POTRZEBOWSKA
JOANNA	WITOS	JOANNA	WITOS
GIACOMO	RUSSO	GIACOMO	RUSSO
JUSSI	HELMINEN	JUSSI	HELMINEN
ANTTI	RANTAMÄKI	ANTTI	RANTAMAKI
ALEXANDRA	ROBCIUC	ALEXANDRA	ROBCIUC
CORINNA	SANWALD	CORINNA	SANWALD
SAMI	HIETALA	SAMI	HIETALA
MODIBO	MOUNGUENGUI-DIALLO	MODIBO	MOUNGUENGUI DIALLO
ELIE	DERRIEN	ELIE	DERRIEN
PHILIPPE	MARION	PHILIPPE	MARION
NOÉMIE	PERRET	NOEMIE	PERRET
SIMON	FONTANAY	SIMON	FONTANAY
YANNICK	KRAUKE	YANNICK	KRAUKE
MATTHIAS	LUEBBERT	MATTHIAS	LUEBBERT
ALBERTO	STRINI	ALBERTO	STRINI
JULIEN	TROQUET	JULIEN	TROQUET
BIRCE	PEKMEZCI KARAMAN	BIRCE	PEKMEZCI KARAMAN
HUSEYIN	ARBAG	HUSEYIN	ARBAG
NURAY	OKTAR	NURAY	OKTAR
GULSEN	DOGU	GULSEN	DOGU
JUSANG	YANG	JUSANG	YANG
JUNGBAE	KIM	JUNGBAE	KIM
KIE MOON	WOO	KIE MOON	WOO
INSEON	LEE	INSEON	LEE
HAN SOL	KIM	HAN SOL	KIM
SUNG-GIL	HONG	SUNG GIL	HONG
HANCHEOL	JEON	HANCHEOL	JEON
EONSEON	JIN	EONSEON	JIN
ANDRÉ	SILVA	ANDRE V S	SILVA
VALÉRIA	EBINUMA	SANTOS EBINUMA	VALERIA DE CARVALHO
WEIYI	OUYANG	WEIYI	OUYANG
ALINA	BALU	ALINA MARIANA	BALU
ANTONIO	ROMERO	ANTONIO ANGEL	ROMERO REYES
JEROME	MIJOIN	JEROME	MIJOIN
SÉBASTIEN	LAFORGE	SEBASTIEN	LAFORGE
MATHIEU	SAUTHIER	MATHIEU	SAUTHIER
ISABELLE	SUISSE	ISABELLE	SUISSE
THIERRY	DELAUNAY	THIERRY	DELAUNAY
VINCENT	WIATZ	VINCENT	WIATZ
HERVÉ	WYART	HERVE	WYART
GEORGIOS	MARGOUTIDIS	GEORGIOS	MARGOUTIDIS
FRANCESCA	KERTON	FRANCESCA	KERTON
MAUDE	BROSSAT	MAUDE	BROSSAT
MAŁGORZATA	SWADŹBA-KWAŚNY	MALGORZATA	SWADZBA KWASNY
MARK	GILMORE	MARK	GILMORE
TETIANA	KULIK	TETIANA	KULIK
KOSTIANTYN	KULYK	KOSTIANTYN	KULYK
BORYS	PALIANYTSIA	BORYS	PALIANYTSIA
JOHN D	ALEXANDER	JOHN D	ALEXANDER
MATS	LARSSON	MATS	LARSSON
ELISABETE	C B A ALEGRIA	ELISABETE C B A	ALEGRIA
ANA	S M L DIAS	ANA S M L	DIAS
CATARINA B B B	GONÇALVES	CATARINA B B B	GONCALVES
MARTA D	SILVA	MARTA D	SILVA
TERESA S C	ROSA	TERESA S C	ROSA
RUI P	OLIVEIRA-SILVA	RUI P	OLIVEIRA SILVA
NATALIA	LIPKOVSKA	NATALIA	LIPKOVSKA
VALENTYNA	BARVINCHENKO	VALENTYNA	BARVINCHENKO
OLGA	KAZAKOVA	OLGA	KAZAKOVA
ALFRÉD	MENYHÁRD	ALFRED	MENYHARD
KRISZTINA	LÁSZLÓ	KRISZTINA	LASZLO
MICHELA	MORSELLA	MICHELA	MORSELLA
T	CANTAT	THIBAULT	CANTAT
CHARLES	CHAUVIN	CHARLES	CHAUVIN
FRÉDÉRIC	LEGALL	FREDERIC	LEGALL
JACQUES	LE PAIH	JACQUES	LE PAIH
DAMIAN	GRAINGER	DAMIAN	GRAINGER
STEPHEN	ROSEBLADE	STEPHEN	ROSEBLADE
GARAZI	TALAVERA	GARAZI	TALAVERA
HANS	NEDDEN	HANS	NEDDEN
ANTONIO	ZANOTTI-GEROSA	ANTONIO	ZANOTTI GEROSA
BEATRIZ	SAAVEDRA	BEATRIZ	SAAVEDRA
NEREA	GONZÁLEZ-GALLARDO	NEREA	GONZALEZ GALLARDO
DIEGO J	RAMÓN	DIEGO J	RAMON
NICOLAS	BRUN	NICOLAS	BRUN
JULIEN	VIEILLARD	JULIEN	VIEILLARD
EMMANUEL	DJOUFAC WOUMFO	EMMANUEL	DJOUFAC WOUMFO
ALFREDO	NAPOLI	ALFREDO	NAPOLI
CHLOÉ	MAES	CHLOE	MAES
MARIE-LAURE	FAUCONNIER	MARIE LAURE	FAUCONNIER
SANDRINE	BOUQUILLON	SANDRINE	BOUQUILLON
KARIM	TANJI	KARIM	TANJI
ABDELHAK	KHERBECHE	ABDELHAK	KHERBECHE
IBRAHIM	BOU MALHAM	IBRAHIM	BOU MALHAM
MIRELLA	AZAR	MIRELLA	AZAR
MANAL	BITAR	MANAL	BITAR
MARTIN	V SINT ANNALAND	MARTIN	VAN SINT ANNALAND
FAUSTO	GALLUCCI	FAUSTO	GALLUCCI
XIN	LIU	XIN	LIU
XUEMING	ZHANG	XUEMING	ZHANG
ELSJE ALESSANDRA	QUADRELLI	ELSJE ALESSANDRA	QUADRELLI
ANNA	BUKOWSKI	ANNA	BUKOWSKI
INÊS	ROCHA	INES	ROCHA
SÓNIA P M	VENTURA	SONIA P M	VENTURA
DOMINIC	ORMEROD	DOMINIC	ORMEROD
MATTHIEU	DORBEC	MATTHIEU	DORBEC
BERT	MAES	BERT	MAES
MINRUI	XU	MINRUI	XU
STÉPHANE	CELERIER	STEPHANE	CELERIER
MATTHIEU	CORBET	MATTHIEU	CORBET
FANI	SOUSA	FANI	SOUSA
BETTY	COTTYN	BETTY	COTTYN BOITTE
FLORIAN	PION	FLORIAN	PION
STEPHANIE	BAUMBERGER	STEPHANIE	BAUMBERGER
RICHARD	GOSSELINK	RICHARD	GOSSELINK
ANNE	BADO-NILLES	ANNE	BADO NILLES
PASCAL	PANDARD	PASCAL	PANDARD
AMEL	MAJIRA	AMEL	MAJIRA
GISLENE	DA SILVA	GISLENE	DA SILVA
LOIS AFUA OKYEREWAA	DAMPTEY	LOIS AFUA OKYEREWAA	DAMPTEY
JOHNSON KWAME	EFAVI	JOHNSON KWAME	EFAVI
COLLINS	OBUAH	COLLINS	OBUAH
KAREN	WILSON	KAREN	WILSON
DORCAS	OSEI-SAFO	DORCAS	OSEI SAFO
DALIA	LIUZZI	DALIA	LIUZZI
CRISTINA	PEINADO	CRISTINA	PEINADO
MARIA	RETUERTO	MARIA	RETUERTO
ROSA M	LADERA	ROSA M	LADERA
MIGUEL A	PEÑA	MIGUEL A	PENA
JOSE L	GARCÍA FIERRO	JOSE L	GARCIA FIERRO
SERGIO	ROJAS	SERGIO	ROJAS
PAULA	DUENAS RAMIREZ	PAULA	DUENAS RAMIREZ
SARAH	KIRCHHECKER	SARAH	KIRCHHECKER
RONALD A	FARRAR-TOBAR	RONALD A	FARRAR TOBAR
ZHIHONG	WIE	ZHIHONG	WEI
HAIJUN	JIAO	HAIJUN	JIAO
SERGEY	TIN	SERGEY	TIN
ZAKARIA	CHERIFI	ZAKARIA	CHERIFI
MÓNICA	CALERO	MONICA	CALERO
Mª ÁNGELES	MARTÍN-LARA	MARIA ANGELES	MARTIN LARA
ANTONIO	PÉREZ	ANTONIO	PEREZ
RAFAEL	FERNÁNDEZ	RAFAEL	FERNANDEZ
MARIA	VENTURA	MARIA	VENTURA
MARCELO EDUARDO	DOMINE	MARCELO EDUARDO	DOMINE
ABDELLAH	ARRAHLI	ABDELLAH	ARRAHLI
GUILLAUME	CHOLLET	GUILLAUME	CHOLLET
THOMAS	WERNER	THOMAS	WERNER
LARS	LONGWITZ	LARS	LONGWITZ
MARKUS	ANTONIETTI	MARKUS	ANTONIETTI
JOAQUIN	GARCÍA ÁLVAREZ	JOAQUIN	GARCIA ALVAREZ
MARÍA JESÚS	RODRÍGUEZ-ÁLVAREZ	MARIA JESUS	RODRIGUEZ ALVAREZ
MOHAMMED	ALSHAMMARI	MOHAMMED	ALSHAMMARI
MOHAMED	BACCOUR	MOHAMED	BACCOUR
JULLIEN	DRONE	JULLIEN	DRONE
ANNE	GALARNEAU	ANNE	GALARNEAU
AHMAD	MEHDI	AHMAD	MEHDI
ANNE-SOPHIE	MORA	ANNE SOPHIE	MORA
SYLVAIN	CAILLOL	SYLVAIN	CAILLOL
THOMAS	HJELMGAARD	THOMAS	HJELMGAARD
PIERRE-ALEXANDRE	DEYRIS	PIERRE ALEXANDRE	DEYRIS
PAULINE	ADLER	PAULINE	ADLER
CAMILLE	BIHANIC	CAMILLE	BIHANIC
MURIEL	BALLOY	MURIEL	BALLOY
BIHANIC	CAMILLE	BIHANIC	CAMILLE
FRANCK	PELISSIER	FRANCK	PELISSIER
IVÁN LEANDRO	RODRÍGUEZ-RICO	IVAN LEANDRO	RODRIGUEZ RICO
GABRIEL	BLÁZQUEZ	GABRIEL	BLAZQUEZ
VENTURA	CASTILLO	VENTURA	CASTILLO
VALENTIN	LACANAU	VALENTIN	LACANAU
HANNES	SELS	HANNES	SELS
HERWIG	DE SMET	HERWIG	DE SMET
JEROEN	GEUENS	JEROEN	GEUENS
SATOKI	SHINOZUKA	SATOKI	SHINOZUKA
SHIORI	IKEGAWA	SHIORI	IKEGAWA
MASAMI	SHIBATA	MASAMI	SHIBATA
FRANCK	RATABOUL	FRANCK	RATABOUL
BOBBY	CUMMING	BOBBY	CUMMING
TONY	COUSIN	TONY	COUSIN
ROULA	FLOUTY	ROULA	FLOUTY
YI-CIN	YANG	YI CIN	YANG
XIN-YING	CHEN	XIN YING	CHEN
VERÓNICA	GODOY	VERONICA	GODOY
ANA KAREN	FLORES-TRUJILLO	ANA KAREN	FLORES TRUJILLO
PEDRO	MARTIN	PEDRO	MARTIN
KIN-YA	TOMIZAKI	KIN YA	TOMIZAKI
MASAHIRO	ASANO	MASAHIRO	ASANO
JULIE	MEIMOUN	JULIE	MEIMOUN
PHILIPPE	ZINCK	PHILIPPE	ZINCK
AUDREY	FAVRELLE	AUDREY	FAVRELLE
YANN	BERNHARD	YANN	BERNHARD
TILL	BOUSQUET	TILL	BOUSQUET
LYDIE	PELINSKI	LYDIE	PELINSKI
SYLVAIN	PELLEGRINI	SYLVAIN	PELLEGRINI
NAZILA	MASOUD	NAZILA	MASOUD
GUILLERMO	BORDANABA FLORIT	GUILLERMO	BORDANABA FLORIT
TOMAS	VAN HAASTERECHT	TOMAS	VAN HAASTERECHT
ULF	PRUESSE	ULF	PRUESSE
SARAH	TSCHIRNER	SARAH	TSCHIRNER
PATRICK	TOMKINS	PATRICK	TOMKINS
KEVIN	MCBRIDE	KEVIN	MCBRIDE
LIISA	RIHKO-STRUCKMANN	LIISA	RIHKO STRUCKMANN
ADITYA	SAHNI	ADITYA	SAHNI
KAI	SUNDMACHER	KAI	SUNDMACHER
STEFFEN	LINKE	STEFFEN	LINKE
LAURÉANNE	PARIZOT	LAUREANNE	PARIZOT
MARIA-ELENA	GALVEZ	MARIA ELENA	GALVEZ PARRUCA
PATRICK	DA COSTA	PATRICK	DA COSTA
HUGO	DUTILLEUL	HUGO	DUTILLEUL
SERGEY I	NIKITENKO	SERGEY I	NIKITENKO
LUCÍLIA	RIBEIRO	LUCILIA SOUSA	RIBEIRO
NATALIA	REY-RAAP	NATALIA	REY RAAP
JOSÉ L	FIGUEIREDO	JOSE L	FIGUEIREDO
M FERNANDO R	PEREIRA	MANUEL FERNANDO RIBEIRO	PEREIRA
EUNMI	KIM	EUNMI	KIM
JAE WON	YOO	JAE WON	YOO
YONG-JIN	KIM	YONG JIN	KIM
JEONG-KEE	KIM	JEONG KEE	KIM
JACOB	PEDERSEN	JACOB	PEDERSEN
ZHENG	GUO	ZHENG	GUO
ELENA	ALVAREZ	ELENA	ALVAREZ
SUSANA	NIETO	SUSANA	NIETO
ANTONIO	DONAIRE	ANTONIO	DONAIRE
GREGORIO	SANCHEZ-GOMEZ	GREGORIO	SANCHEZ GOMEZ
PEDRO	LOZANO	PEDRO	LOZANO
ROCÍO	AROCA	ROCIO	AROCA
AHMED	HALFADJI	AHMED	HALFADJI
MAGDALENA	BRZEZINSKA	MAGDALENA	BRZEZINSKA
NICOLAS	KELLER	NICOLAS	KELLER
THUPTEN	PALDEN	THUPTEN	PALDEN
BIEKE	ONGHENA	BIEKE	ONGHENA
MERCEDES	REGADÍO	MERCEDES	REGADIO
ROCIO	VILLA	ROCIO	AROCA
CELIA	GOMEZ	CELIA	GOMEZ
EDUARDO	GARCIA VERDUGO	EDUARDO	GARCIA VERDUGO
SANTIAGO V	LUIS	SANTIAGO V	LUIS
DOROTHEA	VOSS	DOROTHEA	VOSS
CHANDRAKANT	MUKESH	CHANDRAKANT	MUKESH
ANNA	NIEHUES	ANNA	NIEHUES
JASPER	WATTJES	JASPER	WATTJES
STEFAN	CORD-LANDWEHR	STEFAN	CORD LANDWEHR
BRUNO M	MOERSCHBACHER	BRUNO M	MOERSCHBACHER
EVA K	REGEL	EVA K	REGEL
TOBIAS	WEIKERT	TOBIAS	WEIKERT
LILIANA A	RODRIGUES	LILIANA A	RODRIGUES
CAROLINA V	PEREIRA	CAROLINA V	PEREIRA
JOANA M	SILVA	JOANA M	SILVA
ANA A	MATIAS	ANA ALEXANDRA	MATIAS
OLINDA	GIMELLO	OLINDA	GIMELLO
THOMAS	CACCIAGUERRA	THOMAS	CACCIAGUERRA
ANNA	KANN	ANNA	KANN
HEINRICH	HARTMANN	HEINRICH	HARTMANN
ASTRID	BESMEHN	ASTRID	BESMEHN
PASCAL	VAN DER VOORT	PASCAL	VAN DER VOORT
MARIA	FUENTES	MARIA	FUENTES CAMPOS
FILIPA	LIMA	FILIPA	LIMA
LUÍS C	BRANCO	LUIS C	BRANCO
ISABEL M	MARRUCHO	ISABEL M	MARRUCHO
XAVIER	ROUSSEL	XAVIER	ROUSSEL
PIERRE-YVES	DIVET	PIERRE YVES	DIVET
LORRAINE	CHRIST	LORRAINE	CHRIST
WALID	LAMINE	WALID	LAMINE
SAMIRA	ZAHER	SAMIRA	ZAHER
IYAD	KARAMÉ	IYAD	KARAME
SALIMA	BOUGHDIRI	SALIMA	BOUGHDIRI
CHRISTOPHE	MORELL	CHRISTOPHE	MORELL
HENRY	CHERMETTE	HENRY	CHERMETTE
EDUARDA	S MORAIS	EDUARDA S	MORAIS
ALOIA	ROMANÍ	ALOIA	ROMANI
PEDRO	O SOARES	PEDRO O	SOARES
LUCÍLIA	DOMINGUES	LUCILIA	DOMINGUES
MARA	G FREIRE	MARA G	FREIRE
CARMEN	S R FREIRE	CARMEN S R	FREIRE
ARMANDO	J D SILVESTRE	ARMANDO J D	SILVESTRE
SARA H	COSTA	SARA H	COSTA
ANA M	FERNANDES	ANA M	FERNANDES
ROBIN D	ROGERS	ROBIN D	ROGERS
STEFF	VAN LOY	STEFF	VAN LOY
MEHMET ALI RECAI	ONAL	MEHMET ALI RECAI	ONAL
TOM	VAN GERVEN	TOM	VAN GERVEN
LARS I	LEICHERT	LARS I	LEICHERT
PREMANKUR	SUKUL	PREMANKUR	SUKUL
DENNIS	SANDER	DENNIS	SANDER
YANFEI	YU	YANFEI	YU
FRANK	SCHULZ	FRANK	SCHULZ
SASCHA	HEINRICH	SASCHA	HEINRICH
JULIA	BANDOW	JULIA	BANDOW
SINA	SCHÄKERMANN	SINA	SCHAKERMANN
MINOU	NOWROUSIAN	MINOU	NOWROUSIAN
CARLO	ANGELICI	CARLO	ANGELICI
FERNANDO M J	DOMINGUES	FERNANDO M J	DOMINGUES
ANA FILIPA M	CLÁUDIO	ANA FILIPA M	CLAUDIO
MÓNICA	VÁLEGA	MONICA	VALEGA
ANTOINE	ROLLAND	ANTOINE	ROLLAND
ERIC	LEROY	ERIC	LEROY
ALAIN	SARDA	ALAIN	SARDA
GAËL	COLOMINES	GAEL	COLOMINES
EMMANUEL	CHAILLEUX	EMMANUEL	CHAILLEUX
ADRIEN	GAUCHET	ADRIEN	GAUCHET
DAMIEN	DEBECKER	DAMIEN P	DEBECKER
WENQI	LI	WENQI	LI
PATRICIA	LUIS	PATRICIA	LUIS
WEIGANG	FAN	WEIGANG	FAN
LIANJIE	WANG	LIANJIE	WANG
ETIENNE	GIREL	ETIENNE	GIREL
ALAIN	TUEL	ALAIN	TUEL
ALEXANDRA	CHAUMONNOT	ALEXANDRA	CHAUMONNOT
ANA S	MOURA	ANA S	MOURA
M NATÁLIA D S	CORDEIRO	M NATALIA D S	CORDEIRO
ANAS	IBEN AYAD	ANAS	IBEN AYAD
ERWANN	GUENIN	ERWANN	GUENIN
AISSA	OULD DRIS	AISSA	OULD DRIS
ROGER	GADIOU	ROGER	GADIOU
LIANGYUAN	JIA	LIANGYUAN	JIA
TATEVIK	CHILINGARYAN	TATEVIK	CHILINGARYAN
YANN	LE BRECHT	YANN	LE BRECH
LUC	DELMOTTE	LUC	DELMOTTE
JOCELYNE	BRENDLE	JOCELYNE	BRENDLE
GUILLAIN	MAUVIEL	GUILLAIN	MAUVIEL
ANTHONY	DUFOUR	ANTHONY	DUFOUR
JAN CHRISTOPH	PEINEMANN	JAN CHRISTOPH	PEINEMANN
DANIEL	PLEISSNER	DANIEL	PLEISSNER
SILVIA	FIORE	SILVIA	FIORE
FRANCESCA	DEMICHELIS	FRANCESCA	DEMICHELIS
IRENE	MALPARTIDA	IRENE	MALPARTIDA
PEDRO	MAIRELES	PEDRO J	MAIRELES TORRES
VALENTIN	LAIR	VALENTIN	LAIR
SAMY	HALLOUMI	SAMY	HALLOUMI
JULIEN	THIEL	JULIEN	THIEL
FRANÇOIS	LACOSTE	FRANCOIS	LACOSTE
SERGE	KALIAGUINE	SERGE	KALIAGUINE
JOËLLE	THURIOT	JOELLE	THURIOT
ROBERT	WOJCIESZAK	ROBERT	WOJCIESZAK
ROMAISSA	KHADRAOUI	ROMAISSA	KHADRAOUI
THIERRY	TASSAING	THIERRY	TASSAING
JOSEPH	GRONDIN	JOSEPH	GRONDIN
CHRISTIAN	AUPETIT	CHRISTIAN	AUPETIT
CARMEN	CLAVER	CARMEN	CLAVER
ISABELL	MORITZ	ISABELL	MORITZ
LUKAS	RUEBENACH	LUKAS	RUEBENACH
JOREN	VAN STEE	JOREN	VAN STEE
PHILIPPE	MARECHAL	PHILIPPE	MARECHAL
ZHENG	LI	ZHENG	LI
MARIA J	QUENTAL	MARIA J	QUENTAL
PEDRO	AUGUSTO	PEDRO	AUGUSTO
PATRÍCIA	PEREIRA	PATRICIA	PEREIRA
JOÃO A	QUEIROZ	JOAO A	QUEIROZ
FERNANDA	GUERRA LIMA MEDEIROS BORSAGLI	FERNANDA	GUERRA LIMA MEDEIROS BORSAGLI
ANA JÚLIA	MARTINS SOUZA	ANA JULIA	MARTINS SOUZA
MAX	PEREIRA GONÇALVES	MAX	PEREIRA GONCALVES
PATRÍCIA	NIRLANE DA COSTA SOUZA	PATRICIA	NIRLANE DA COSTA SOUZA
RAFAEL	FRANCISCO	RAFAEL	FRANCISCO
CLAIRE	BESNARD	CLAIRE	BESNARD
ALAIN	FAVRE-RÉGUILLON	ALAIN	FAVRE REGUILLON
TOM	RENDERS	TOM	RENDERS
JULIEN	MARBAIX	JULIEN	MARBAIX
BRUNO	CHAUDRET	BRUNO	CHAUDRET
LUDOVIC	MONTASTRUC	LUDOVIC	MONTASTRUC
KATERINA	SOULANTIKA	KATERINA	SOULANTIKA
HUGO	CRUCHADE	HUGO	CRUCHADE
BENJAMIN	KATRYNIOK	BENJAMIN	KATRYNIOK
KAREN	SILVA	KAREN	SILVA
MARCIA CAROLINA	ARAQUE MARIN	MARCIA CAROLINA	ARAQUE MARIN
SEBASTIEN	PAUL	SEBASTIEN	PAUL
CORNELIA	BROICHER	CORNELIA	BROICHER
QINGTAO	HU	QINGTAO	HU
LISA	MAYERL	LISA	MAYERL
TIMO	BISSWANGER	TIMO	BISSWANGER
STEFAN	PALKOVITS	STEFAN	PALKOVITS
AN-HUI	LU	AN HUI	LU
JOAN	MANYA	JOAN	MANYA
BELEN	GONZALEZ	BELEN	GONZALEZ
DAVID	GARCIA-MORCATE	DAVID	GARCIA MORCATE
DARIO	ALVIRA	DARIO	ALVIRA
CHRISTIAN	DI STASI	CHRISTIAN	DI STASI
CÉDRIC	VAN GOETHEM	CEDRIC	VAN GOETHEM
IVO	VANKELECOM	IVO	VANKELECOM
BERT	LAGRAIN	BERT	LAGRAIN
KWINTEN	JANSSENS	KWINTEN	JANSSENS
CARLOS	MARQUEZ	CARLOS	MARQUEZ
FRANCISCO	GARCIA CIRUJANO	FRANCISCO	GARCIA CIRUJANO
NUNO	SILVA	NUNO N H	SILVA
CARLA	VILELA	CARLA	VILELA
RICARDO	PINTO	RICARDO	PINTO
ISABEL	MARRUCHO	ISABEL M	MARRUCHO
MADJID	OUALI	MADJID	OUALI
MAROUA	BOUCHNEB	MAROUA	BOUCHNEB
JOHAN	ALAUZUN	JOHAN	ALAUZUN
HUBERT	MUTIN	HUBERT	MUTIN
GILLES	SEBE	GILLES	SEBE
NICOLAS	JOLY	NICOLAS	JOLY
ANGÉLIQUE	MAHIEU	ANGELIQUE	MAHIEU
VINCENT	LEQUART	VINCENT	LEQUART
CAROLINE	TERRIÉ	CAROLINE	TERRIE
PATRICK	MARTIN	PATRICK	MARTIN
NATHALIE	LEBLANC	NATHALIE	LEBLANC
SÓNIA	PEDRO	SONIA	PEDRO
KEVIN	LE DEZ	KEVIN	LE DEZ
HAMED	ISSAOUI	HAMED	ISSAOUI
AGBOSSOU-NIEDERCORN	FRANCINE	AGBOSSOU NIEDERCORN	FRANCINE
LORI	GONNET	LORI	GONNET
ALAIN	CHAMAYOU	ALAIN	CHAMAYOU
BRIGITTE	GUIDETTI	BRIGITTE	GUIDETTI
CHRISTIANE	ANDRÉ-BARRÈS	CHRISTIANE	ANDRE BARRES
MICHEL	BARON	MICHEL	BARON
MICHEL	BALTAS	MICHEL	BALTAS
RACHEL	CALVET	RACHEL	CALVET
KAREN	LEUS	KAREN	LEUS
QING	QIN	QING	QIN
NADJA	TARAKINA	NADJA	TARAKINA
JOHANNES	SCHMIDT	JOHANNES	SCHMIDT
MARTIN	OSCHATZ	MARTIN	OSCHATZ
TAE WOO	LEE	TAE WOO	LEE
JUNG WOON	YANG	JUNG WOON	YANG
MARIA ELENA	GALVEZ	MARIA ELENA	GALVEZ PARRUCA
KAIES	SOUIDI	KAIES	SOUIDI
DAVID	DEPRAETERE	DAVID	DEPRAETERE
DANIEL	WILS	DANIEL	WILS
YOLANDA	RODENAS OLAYA	YOLANDA	RODENAS OLAYA
ANA CAROLINA	ALBA RUBIO	ANA CAROLINA	ALBA RUBIO
RAFAEL	MARISCAL LOPEZ	RAFAEL	MARISCAL LOPEZ
DAVID	MARTIN-ALONSO	DAVID	MARTIN ALONSO
FRANCISCO	VILA	FRANCISCO	VILA
XIN	SU	XIN	SU
SEUANES SERAFIM	LUÍSA	SEUANES SERAFIM	LUISA
LUÍSA	SERAFIM	LUISA S	SERAFIM
PAULO	LEMOS	PAULO C	LEMOS
SYLVIE	DHULUT	SYLVIE	DHULUT
PIERRE-FRANÇOIS	VITTOZ	PIERRE FRANCOIS	VITTOZ
CAROLIEN	VIS	CAROLIEN	VIS
LUC	SMULDERS	LUC	SMULDERS
ANNE-EVA	NIEUWELINK	ANNE EVA	NIEUWELINK
NORMA	MAURICE	NORMA	MAURICE
LUCIE	LESEURRE	LUCIE	LESEURRE
FRÉDÉRIC	POINT	FREDERIC	POINT
JEAN-JACQUES	SCHOONJANS	JEAN JACQUES	SCHOONJANS
JOEL B	MENSAH	JOEL B	MENSAH
JÉRÔME	MEYERS	JEROME	MEYERS
FABIAN JOSCHKA	HOLZHÄUSER	FABIAN JOSCHKA	HOLZHAUSER
MARÍA	RETUERTO	MARIA	RETUERTO
JOSÉ L	GARCÍA FIERRO	JOSE L	GARCIA FIERRO
PAOLA	BLAIR VASQUEZ	PAOLA	BLAIR VASQUEZ
ELEONORA	MONTI	ELEONORA	MONTI
NIKOLAOS	DIMITRATOS	NIKOLAOS	DIMITRATOS
ANA P M	TAVARES	ANA P M	TAVARES
JÉRÉMY	MEHATS	JEREMY	MEHATS
LAURENT	CASTETS	LAURENT	CASTETS
CHARAFEDDINE	JAMA	CHARAFEDDINE	JAMA
PABLO	JUAREZ	PABLO	JUAREZ
VINCENT	TERRASSON	VINCENT	TERRASSON
ERWANN	GUÉNIN	ERWANN	GUENIN
ALEXIS	METAIS	ALEXIS	METAIS
WU	LONG	WU	LONG
ZEPING	ZHOU	ZEPING	ZHOU
UMA	DWIVEDI	UMA	DWIVEDI
K K	PANT	KAMAL KISHORE	PANT
S N	NAIK	SATYA NARAYAN	NAIK
ATSUSHI	FUKUOKA	ATSUSHI	FUKUOKA
PRASHANT	JADHAO	PRASHANT	JADHAO
KAMAL	PANT	KAMAL KISHORE	PANT
K D P	NIGAM	K D P	NIGAM
FENG	CHEN	FENG	CHEN
VIOLETTA	POSPELOVA	VIOLETTA	POSPELOVA
JAROSLAV	AUBRECHT	JAROSLAV	AUBRECHT
MILOSLAV	LHOTKA	MILOSLAV	LHOTKA
THIJS	VANGEEL	THIJS	VANGEEL
SANDER	VAN DEN BOSCH	SANDER	VAN DEN BOSCH
GIL	VAN DEN BOSSCHE	GIL	VAN DEN BOSSCHE
KORNEEL	VAN AELST	KORNEEL	VAN AELST
LILIANA	BASTOS	LILIANA	BASTOS
DANIEL	WEINGART BARRETO	DANIEL	WEINGART BARRETO
BERNARDO	DIAS RIBEIRO	BERNARDO	DIAS RIBEIRO
NUNO	N H SILVA	NUNO N H	SILVA
TÂNIA	E SINTRA	TANIA E	SINTRA
SÓNIA	A O SANTOS	SONIA A O	SANTOS
BRUNO	MIGUEL NEVES	BRUNO	MIGUEL NEVES
ISABEL	F ALMEIDA	ISABEL F	ALMEIDA
PAULO	C COSTA	PAULO C	COSTA
INÊS	CORREIA-SÁ	INES	CORREIA SA
SÓNIA	P M VENTURA	SONIA P M	VENTURA
BELINDA	SOARES	BELINDA	SOARES
CARMEN S R	FREIRE	CARMEN S R	FREIRE
ANNE	LORON	ANNE	LORON
VÉRONIQUE	COMA	VERONIQUE	COMA
CHRISTIAN	GARDRAT	CHRISTIAN	GARDRAT
VESSELA	ATANASOVA-PENICHON	VESSELA	ATANASOVA PENICHON
NICOLAS	TABARY	NICOLAS	TABARY
BERNARD	MARTEL	BERNARD	MARTEL
MEHDI	OMRI	MEHDI	OMRI
MATTHIEU	BECUWE	MATTHIEU	BECUWE
GWLADYS	POURCEAU	GWLADYS	POURCEAU
ANNE	WADOUACHI	ANNE	WADOUACHI
GUILLAUME	FALCO	GUILLAUME	FALCO
LUC	VINCENT	LUC	VINCENT
PHILIPPE	ELIAERS	PHILIPPE	ELIAERS
MATHIEU	DUBOIS	MATHIEU	DUBOIS
CHRISTELLE	VANOOSTHUYZE	CHRISTELLE	VANOOSTHUYZE
UMBERTO	PASQUAL LAVERDURA	UMBERTO	PASQUAL LAVERDURA
ANTONIO	ZARLI	ANTONIO	ZARLI
LEUCIO	ROSSI	LEUCIO	ROSSI
AMPARO	JIMENEZ QUERO	AMPARO	JIMENEZ QUERO
ANTONIO	MARTÍNEZ-ABAD	ANTONIO	MARTINEZ ABAD
ANDREA C	RUTHES	ANDREA C	RUTHES
FRANCISCO	VILAPLANA	FRANCISCO	VILAPLANA
CHANGWEI	HU	CHANGWEI	HU
LIANE	MENESES	LIANE	MENESES
THOMAS	DE DIOS MIGUEL	THOMAS	DE DIOS MIGUEL
CLAIRE	MOULIS	CLAIRE	MOULIS
LILIVET	UBIERA	LILIVET	UBIERA
ISABELLE	POLAERT	ISABELLE	POLAERT
CHANDRASHEKHAR	RODE	CHANDRASHEKHAR	RODE
SANJAY	JADHAV	SANJAY	JADHAV
FIONA	MAGLIOZZI	FIONA	MAGLIOZZI
FRÉDÉRIC	SAUVAGE	FREDERIC	SAUVAGE
SÉMA	GOLONU	SEMA	GOLONU
EMILIA	SOSZKA	EMILIA	SOSZKA
IZABELA	RZEZNICKA	IZABELA	RZEZNICKA
KELECHUKWU	ONWUKAMIKE	KELECHUKWU	ONWUKAMIKE
MICHAEL	MEIER	MICHAEL A R	MEIER
SARAH	LE GUENIC	SARAH	LE GUENIC
MARYLINE	CALONNE-SALMON	MARYLINE	CALONNE SALMON
MATHILDE	ROBINEAU	MATHILDE	ROBINEAU
LUDOVIC	CHAVERIAT	LUDOVIC	CHAVERIAT
STEPHAN	DOREY	STEPHAN	DOREY
QASSIM	ESMAEEL	QASSIM	ESMAEEL
CÉDRIC	JACQUART	CEDRIC	JACQUART
LISA	SANCHEZ	LISA	SANCHEZ
ESSAÏD	AÏT BARKA	ESSAID	AIT BARKA
STÉPHANE	DECLERCK	STEPHANE	DECLERCK
ADRIEN	LUSTERIO	ADRIEN	LUSTERIO
DANIELA	PAINER	DANIELA	PAINER
VITALY	ORDOMSKY	VITALY	ORDOMSKY
ANDREI	KHODAKOV	ANDREI	KHODAKOV
HANS	HEERES	HANS	HEERES
MAJD	AL-NAJI	MAJD	AL NAJI
BEGOÑA	PUÉRTOLAS	BEGONA	PUERTOLAS
BARIS	KUMRU	BARIS	KUMRU
JAVIER	PÉREZ‐RAMÍREZ	JAVIER	PEREZ RAMIREZ
YEHAN	TAO	YEHAN	TAO
FRANCESCO	PICCHIONI	FRANCESCO	PICCHIONI
PAOLO	PESCARMONA	PAOLO P	PESCARMONA
SATYA NARAYAN	NAIK	SATYA NARAYAN	NAIK
FALGUNI	PATTNAIK	FALGUNI	PATTNAIK
AJAY K	DALAI	AJAY K	DALAI
VIVEK	KUMAR	VIVEK	KUMAR
MARTIJN	DROESBEKE	MARTIJN	DROESBEKE
SAMIR	KASMI	SAMIR	KASMI
GIOVANNI	MARANI	GIOVANNI	MARANI
ROSA	PRATI	ROSA	PRATI
JACOPO	DE MARON	JACOPO	DE MARON
MARTINA	EBERLE	MARTINA	EBERLE
BIN	ZHANG	BIN	ZHANG
CHAN-CHENG	CHEN	CHAN CHENG	CHEN
ZHI-LING	XU	ZHI LING	XU
TANA	TANA	TANA	TANA
WILLIAM	DOHERTY	WILLIAM	DOHERTY
MEKRO PERMANA	PINEM	MEKRO PERMANA	PINEM
ENDARTO Y	WARDHONO	ENDARTO Y	WARDHONO
HADI	WAHYUDI	HADI	WAHYUDI
SRI	AGUSTINA	SRI	AGUSTINA
DANIÈLE	CLAUSSE	DANIELE	CLAUSSE
KHASHAYAR	SALEH	KHASHAYAR	SALEH
CARLO	GILIBERTI	CARLO	GILIBERTI
MÓNIA A R	MARTINS	MONIA A R	MARTINS
SIMÃO P	PINHO	SIMAO P	PINHO
HUBERT	CASAJUS	HUBERT	CASAJUS
FLORIAN	PONZIO	FLORIAN	PONZIO
KAMAL	REKAB	KAMAL	REKAB
CHENG-TAO	FENG	CHENG TAO	FENG
LILIANA P	SILVA	LILIANA P	SILVA
DINIS O	ABRANCHES	DINIS O	ABRANCHES
HASAN TANVIR	IMAM	HASAN TANVIR	IMAM
AMANDA G	JARVIS	AMANDA G	JARVIS
PAUL C J	KAMER	PAUL C J	KAMER
ELISABETH	KLINDTWORTH	ELISABETH	KLINDTWORTH
NILS	GUNTERMANN	NILS	GUNTERMANN
LUCIA	PANZELLA	LUCIA	PANZELLA
VERONICA	AMBROGI	VERONICA	AMBROGI
MARIA ROSARIA	CATANIA	MARIA ROSARIA	CATANIA
PIERFRANCESCO	CERRUTI	PIERFRANCESCO	CERRUTI
LUIS	GOYA	LUIS	GOYA
JOSÉ ÁNGEL	RUFIÁN-HENARES	JOSE ANGEL	RUFIAN HENARES
ALESSANDRA	NAPOLITANO	ALESSANDRA	NAPOLITANO
MARCO	D'ISCHIA	MARCO	DISCHIA
ANNELIE	JONGERIUS	ANNELIE	JONGERIUS
CRISTOBAL	AGUILAR	CRISTOBAL	AGUILAR
JUAN ALBERTO	ASCACIO-VALDES	JUAN ALBERTO	ASCACIO VALDES
DANIELE	NAVIGLIO	DANIELE	NAVIGLIO
LUISELLA	VEROTTA	LUISELLA	VEROTTA
ZHENCHEN	TANG	ZHENCHEN	TANG
DINA	BOER	DINA	BOER
HERO	HEERES	HERO	HEERES
JAEHOON	KIM	JAEHOON	KIM
ANDREA	DELL'ACQUA	ANDREA	DELLACQUA
JOHANNES GERARDUS	DE VRIES	JOHANNES GERARDUS	DE VRIES
THIERRY	ROISNEL	THIERRY	ROISNEL
AURELIEN	FOUQUET	AURELIEN	FOUQUET
CATHERINE	ESPECEL	CATHERINE	ESPECEL
LAURENCE	VIVIER	LAURENCE	VIVIER
ARNO	BRINGER	ARNO	BRINGER
MARINA	ALISTE	MARINA	ALISTE
GABRIEL	PÉREZ-LUCAS	GABRIEL	PEREZ LUCAS
NURIA	VELA	NURIA	VELA
ISABEL	GARRIDO	ISABEL	GARRIDO
MARÍA JOSÉ	YÁÑEZ-GASCÓN	MARIA JOSE	YANEZ GASCON
JOSÉ	FENOLL	JOSE	FENOLL
SIMÓN	NAVARRO	SIMON	NAVARRO
CHI MIN	SHU	CHI MIN SHU	SHU
ALESSA	HINZMANN	ALESSA	HINZMANN
HARALD	GROEGER	HARALD	GROEGER
MORITZ	HAUS	MORITZ O	HAUS
YANNIK	LOUVEN	YANNIK	LOUVEN
VINCENZO	RUSSO	VINCENZO	RUSSO
PÄIVI	MÄKI‑ARVELA	PAIVI	MAKI ARVELA
MARTINO	DI SERIO	MARTINO	DI SERIO
ANTOINE	FRANCHE	ANTOINE	FRANCHE
ESTELLE	LEONARD	ESTELLE	BANASZAK LEONARD
ANTOINE	FAYEULLE	ANTOINE	FAYEULLE
DANIELA	UBIALI	DANIELA	UBIALI
NICOLETTA	RAVASIO	NICOLETTA	RAVASIO
KALLIOPI	AVRAMIDOU	KALLIOPI	AVRAMIDOU
GIUSEPPE	CAPPELLETTI	GIUSEPPE	CAPPELLETTI
DAVIDE	ROSA	DAVIDE	ROSA
DENISE	CAVUOTO	DENISE	CAVUOTO
CARLO F	MORELLI	CARLO F	MORELLI
GIORGIO	MARRUBINI	GIORGIO	MARRUBINI
TEODORA	BAVARO	TEODORA	BAVARO
SARA	SANGIORGIO	SARA	SANGIORGIO
GIOVANNA	SPERANZA	GIOVANNA	SPERANZA
MARIA	GUTIÉRREZ	MARIA	GUTIERREZ
ALVARO	ORJUELA	ALVARO	ORJUELA
MARIAM	RIFI	MARIAM	RIFI
BASSEM	YASSINE	BASSEM	YASSINE
VICTORIEN	JEUX	VICTORIEN	JEUX
ESTELLE	LÉONARD	ESTELLE	BANASZAK LEONARD
SIMON	RENGSHAUSEN	SIMON	RENGSHAUSEN
ALEXIS	BORDET	ALEXIS	BORDET
FRANCESCO	BRANDI	FRANCESCO	BRANDI
MARIUS	BAUEMEL	MARIUS	BAUMEL
IRINA	SHEKOVA	IRINA	SHEKOVA
VALERIO	MOLINARI	VALERIO	MOLINARI
MAJD	AL NAJI	MAJD	AL NAJI
DUO	WEI	DUO	WEI
VINCENT	DORCET	VINCENT	DORCET
DMITRY A	VALYAEV	DMITRY A	VALYAEV
NOËL	LUGAN	NOEL	LUGAN
NORBERT	PATOUILLARD	NORBERT	PATOUILLARD
CRISTINA	BELDA MARIN	CRISTINA	BELDA MARIN
ELODIE	COLACO	ELODIE	COLACO
CAROLINE	LEFEBVRE	CAROLINE	LEFEBVRE
JESSEM	LANDOULSI	JESSEM	LANDOULSI
AISSA	OULD DRISS	AISSA	OULD DRIS
MOSTAFA	NAWDALI	MOSTAFA	NAWDALI
HICHAM	ZAITAN	HICHAM	ZAITAN
IMANE	EL MRABET	IMANE	EL MRABET
MARTA	RAMOS ANDRÉS	MARTA	RAMOS ANDRES
JUAN	GARCÍA SERNA	JUAN	GARCIA SERNA
ZHE	LIU	ZHE	LIU
HUAIYONG	ZHU	HUAI YONG	ZHU
DEEPAK	VERMA	DEEPAK	VERMA
GLADYS	ATEN	GLADYS	ATEN
GUILLAUME	RIVIERE	GUILLAUME	RIVIERE
ANTTI	KORPI	ANTTI	KORPI
TAO	ZOU	TAO	ZOU
MIKA	SIPPONEN	MIKA	SIPPONEN
MAURI	KOSTIAINEN	MAURI	KOSTIAINEN
MONIKA	ÖSTERBERG	MONIKA	OSTERBERG
GUANGXING	LI	GUANGXING	LI
WENBO	HUANG	WENBO	HUANG
ÉLISE	CORBI	ELISE	CORBI
CHRISTOPHE	PERES	CHRISTOPHE	PERES
BASTIEN	RACCARY	BASTIEN	RACCARY
NIDHI	HANS	NIDHI	HANS
SATYANARAYAN	NAIK	SATYA NARAYAN	NAIK
EDUARDA	MORAIS	EDUARDA S	MORAIS
LEONARDO MENDES	DE SOUZA MESQUITA	LEONARDO MENDES	DE SOUZA MESQUITA
LUCIANA	PISANI	LUCIANA	PISANI
VERIDIANA	V DE ROSSO	VERIDIANA V	DE ROSSO
LAURA	MAZZOCCHETTI	LAURA	MAZZOCCHETTI
EMANUELE	MACCAFERRI	EMANUELE	MACCAFERRI
ANDREA	ZUCCHELLI	ANDREA	ZUCCHELLI
CHIARA	GUALANDI	CHIARA	GUALANDI
MARIA LETIZIA	FOCARETE	MARIA LETIZIA	FOCARETE
LORIS	GIORGINI	LORIS	GIORGINI
STEFANIA	SOLMI	STEFANIA	SOLMI
CALOGERO	MORREALE	CALOGERO	MORREALE
FILIPE	SOSA	FILIPE	SOSA
MARIANA	DA COSTA	MARIANA	DA COSTA
SIMONA	ORTELLI	SIMONA	ORTELLI
ANNA LUISA	COSTA	ANNA LUISA	COSTA
MAGDA	BLOSI	MAGDA	BLOSI
RICCARDO	BACILE	RICCARDO	BACILE
JOSÉ	PINTO	JOSE	PINTO
JORGE	CAPITÃO-MOR	JORGE	CAPITAO MOR
ANA	AGUIAR-RICARDO	ANA	AGUIAR RICARDO
TELMA	BARROSO	TELMA	BARROSO
SONIA	SANTOS	SONIA A O	SANTOS
ADRIANA	PAIS	ADRIANA	PAIS
JORGE	SARAIVA	JORGE	SARAIVA
DONGQIANG	MA	DONGQIANG	MA
LANGYOU	WEN	LANGYOU	WEN
KEYONG	YANG	KEYONG	YANG
BAONING	ZONG	BAONING	ZONG
JOSÉ	IGLESIAS	JOSE	IGLESIAS
MIGUEL	MONTERO	MIGUEL	MONTERO
JORGE	BLANCO	JORGE	BLANCO
MING	YAO	MING	YAO
LI	LI	LI	LI
XIXIONG	YANG	XIXIONG	YANG
CARINA	HEISIG	CARINA	HEISIG
CHRISTOPH	GLOTZBACH	CHRISTOPH	GLOTZBACH
THOMAS	TUREK	THOMAS	TUREK
VADIM	SAMOILOV	VADIM	SAMOILOV
DENIS	NI	DENIS	NI
GEORGIY	DMITRIEV	GEORGIY	DMITRIEV
LEONID	ZANAVESKIN	LEONID	ZANAVESKIN
ANTON	MAXIMOV	ANTON	MAXIMOV
GERALD	ENDERLIN	GERALD	ENDERLIN
MARIAM	KHOLANY	MARIAM	KHOLANY
JOÃO	VIEIRA	JOAO	VIEIRA
PAULINE	TRÉBULLE	PAULINE	TREBULLE
JEAN-MARC	NICAUD	JEAN MARC	NICAUD
STAMATIA	KARAKOULIA	STAMATIA	KARAKOULIA
KONSTANTINOS	KALOGIANNIS	KONSTANTINOS	KALOGIANNIS
SARINA	SARINA	SARINA	SARINA
MARGUERITA	ROSA	MARGUERITA	ROSA
PIETRO	SQUILLACE	PIETRO	SQUILLACE
DIMITRIOS	IPSAKIS	DIMITRIOS	IPSAKIS
NICOLAS	SCHAEFFER	NICOLAS	SCHAEFFER
MATTHIEU	GRAS	MATTHIEU	GRAS
GERMAN	PEREZ-SANCHEZ	GERMAN	PEREZ SANCHEZ
ISABELLE	BILLARD	ISABELLE	BILLARD
NICOLAS	PAPAICONOMOU	NICOLAS	PAPAICONOMOU
VIJETHA	MOGILIREDDY	VIJETHA	MOGILIREDDY
RESKANDI	RUDJITO	RESKANDI	RUDJITO
AMPARO	JIMÉNEZ-QUERO	AMPARO	JIMENEZ QUERO
SECIL	YILMAZ TURAN	SECIL	YILMAZ TURAN
ROSANA	MORIANA TORRO	ROSANA	MORIANA TORRO
EDIS	GLOGIC	EDIS	GLOGIC
ALBERTO	ADAN MAS	ALBERTO	ADAN MAS
STEVEN B	YOUNG	STEVEN B	YOUNG
EDUARDO J	GARCIA-SUAREZ	EDUARDO J	GARCIA SUAREZ
BELEN	MAESTRO-MADURGA	BELEN	MAESTRO MADURGA
JONATAN	PEREZ-ARCE	JONATAN	PEREZ ARCE
HARTMUT	HENNEKEN	HARTMUT	HENNEKEN
JOSE R	OCHOA-GOMEZ	JOSE R	OCHOA GOMEZ
PÄIVI	MÄKI-ARVELA	PAIVI	MAKI ARVELA
JOHAN	WÄRNÅ	JOHAN	WARNA
PAULO C	LEMOS	PAULO C	LEMOS
LUISA S	SERAFIM	LUISA S	SERAFIM
JAIME	MAZARIO	JAIME	MAZARIO
ZAHER	RAAD	ZAHER	RAAD
OMAR	ABDELAZIZ	OMAR	ABDELAZIZ
FLORIAN	WALCH	FLORIAN	WALCH
CHRISTIAN	HULTEBERG	CHRISTIAN	HULTEBERG
AUDREY	SAHUT	AUDREY	SAHUT
STÉPHANIE	CASSEL	STEPHANIE	CASSEL
MURIEL	BLANZAT	MURIEL	BLANZAT
NAGAPHANI KUMAR	BATCHU	NAGAPHANI KUMAR	BATCHU
LAURIE	VERZEAUX	LAURIE	VERZEAUX
JOHAN	VIGUIER	JOHAN	VIGUIER
DAVID	BOUDIER	DAVID	BOUDIER
MICHEL	DANA	MICHEL	DANA
BRIGITTE	CLOSS	BRIGITTE	CLOSS
CARMEN P	JIMÉNEZ-GÓMEZ	CARMEN PILAR	JIMENEZ GOMEZ
JUAN A	CECILIA	JUAN ANTONIO	CECILIA
CHIARA	DEFILIPPI	CHIARA	DEFILIPPI
CRISTINA	GIORDANO	CRISTINA	GIORDANO
FILIPA	SANTOS	FILIPA	SANTOS
ADRIANA	FREITES AGUILERA	ADRIANA	FREITES AGUILERA
SÉBASTIEN	LEVENEUR	SEBASTIEN	LEVENEUR
BRAYAN	CRUZ	BRAYAN	CRUZ
CARLA	PATINHA	CARLA	PATINHA
EDUARDO FERREIRA DA	SILVA	EDUARDO	FERREIRA DA SILVA
ROSANGELA	SPINELLI	ROSANGELA	SPINELLI
MONIA	MONTORSI	MONIA	MONTORSI
LARA	MAISTRELLO	LARA	MAISTRELLO
AUGUSTA	CALIGIANI	AUGUSTA	CALIGIANI
MANAL	YACOUB	MANAL	YACOUB
ILABAHEN	PATEL	ILABAHEN	PATEL
MICHAEL	LECOURT	MICHAEL	LECOURT
FRÉDÉRIC	LEGÉE	FREDERIC	LEGEE
DAVID	NAVARRO	DAVID	NAVARRO
KELLY	BIAGGINI	KELLY	BIAGGINI
DEHBIA	CHENA	DEHBIA	CHENA
THÉO	DUPONT	THEO	DUPONT
BARBARA	FIFANI	BARBARA	FIFANI
LAURA	MUNOZ DUARTE	LAURA	MUNOZ DUARTE
ANNICK	DOAN	ANNICK	DOAN
GIULIANO	SCIARA	GIULIANO	SCIARA
BENJAMIN	TATTIER	BENJAMIN	TATTIER
MARIA ALICE	ZARUR COELHO	MARIA ALICE	ZARUR COELHO
ARIANE	GASPAR SANTOS	ARIANE	GASPAR SANTOS
XAVIER	SOLIMANDO	XAVIER	SOLIMANDO
FADHILA	SALHI	FADHILA	SALHI
SIHAM	BENANANE	SIHAM	BENANANE
CARLA	PEREIRA	CARLA	PEREIRA
RUI	M V ABREU	RUI M V	ABREU
RICARDO	C CALHELHA	RICARDO C	CALHELHA
MARIA JOSÉ	ALVES	MARIA JOSE	ALVES
UWE	BORNSCHEUER	UWE	BORNSCHEUER
IRENE	ERDELMEIER	IRENE	ERDELMEIER
MOHAMED	MOSTAFA	MOHAMED	MOSTAFA
BODOUR	ALHASHDI	BODOUR	ALHASHDI
HEBA	KASHMERY	HEBA	KASHMERY
NESREEN S	AHMED	NESREEN S	AHMED
QUIM	TARRÉS	QUIM	TARRES
MARC	DELGADO-AGUILAR	MARC	DELGADO AGUILAR
PERE	MUTJÉ	PERE	MUTJE
ALI	SAIBA	ALI	SAIBA
ABDELMALEK	BADIS	ABDELMALEK	BADIS
SIDALI	KOURDALI	SIDALI	KOURDALI
TZONKA	MINEVA	TZONKA	MINEVA
SONIA MILENA	AGUILERA SEGURA	SONIA MILENA	AGUILERA SEGURA
DAYONG	SANG	DAYONG	SANG
HANGXING	XIONG	HANGXING	XIONG
IVAN	YAREMENKO	IVAN	YAREMENKO
FABRICE	FLEURY	FABRICE	FLEURY
ALAIN	GRAILLOT	ALAIN	GRAILLOT
CÉDRIC	LOUBAT	CEDRIC	LOUBAT
SAMUEL	MALBURET	SAMUEL	MALBURET
ANTONY	FERNANDES	ANTONY	FERNANDES
LAURENT	BILLON	LAURENT	BILLON
EVELYNE	FARGIN	EVELYNE	FARGIN
THIERRY	CARDINAL	THIERRY	CARDINAL
MARC	DUSSAUZE	MARC	DUSSAUZE
ANGELINE	POULON	ANGELINE	POULON
PIERRE-ADRIEN	PAYARD	PIERRE ADRIEN	PAYARD
MARC	PERA-TITUS-EXT	MARC	PERA TITUS
LAURENCE	GRIMAUD	LAURENCE	GRIMAUD
RAPHAEL	WISCHERT	RAPHAEL	WISCHERT
LHOUSSAIN	KHROUZ	LHOUSSAIN	KHROUZ
LAURENT	BONNEVIOT	LAURENT	BONNEVIOT
WENJUAN	ZHOU	WEN JUAN	ZHOU
YU-TING	ZHENG	YU TING	ZHENG
EUCHARIA	NWAICHI	EUCHARIA	NWAICHI
GILBERT	ATTUAH	GILBERT	ATTUAH
PAUL	NWOHA	PAUL	NWOHA
IWO	GODKNOWS	IWO	GODKNOWS
HELEN	SNEDDON	HELEN	SNEDDON
SANGHOON	KIM	SANGHOON	KIM
LAURE	MONCONDUIT	LAURE	MONCONDUIT
LORENZO	STIEVANO	LORENZO	STIEVANO
NICOLAS	LOUVAIN	NICOLAS	LOUVAIN
BRUNO	BOURY	BRUNO	BOURY
LUDIVINE	VAN DEN BIGGELAAR	LUDIVINE	VAN DEN BIGGELAAR
MOHAMMAD SHAHNEAWZ	KHAN	MOHAMMAD SHAHNEAWZ	KHAN
PATRICE	SOUMILLION	PATRICE	SOUMILLION
MARION	CHEVALLIER	MARION	CHEVALLIER
LUCILE	BRUYAT	LUCILE	BRUYAT
FANNY	SERRES	FANNY	SERRES
BERNARD	DAVID	BERNARD	DAVID
JEAN-MICHEL	ANDANSON	JEAN MICHEL	ANDANSON
OLYMPE	LONGERAS	OLYMPE	LONGERAS
KARINE	BALLERAT-BUSSEROLLES	KARINE	BALLERAT BUSSEROLLES
PANAGIOTA	MANARA	PANAGIOTA	MANARA
STELLA	BEZERGIANNI	STELLA	BEZERGIANNI
ATHANASIOS	DIMITRIADIS	ATHANASIOS	DIMITRIADIS
ULRICH	PFISTERER	ULRICH	PFISTERER
LAURENT	LEMEE	LAURENT	LEMEE
WASSILA	KORICHI	WASSILA	KORICHI
MANAR	IBRAHIMI	MANAR	IBRAHIMI
SOUAD	LOQMAN	SOUAD	LOQMAN
YEDIR	OUHDOUCH	YEDIR	OUHDOUCH
NATALIA	CANDU	NATALIA	CANDU
MAGDI	EL FERGANI	MAGDI	EL FERGANI
KOEN	ADRIAENSEN	KOEN	ADRIAENSEN
MARÍA EUGENIA	SAD	MARIA EUGENIA	SAD
CRISTINA	PADRÓ	CRISTINA	PADRO
EMANUEL	VIRGILIO	EMANUEL	VIRGILIO
FARIDA	ALLAL	FARIDA	ALLAL
ERIC	MULLER	ERIC	MULLER
SHI	JIANG	SHI	JIANG
FRANÇOIS	JERÔME	FRANCOIS	JEROME
VICTORIA	PAZO-CEPEDA	VICTORIA	PAZO CEPEDA
SOLEDAD GUADALUPE	ASPROMONTE	SOLEDAD GUADALUPE	ASPROMONTE
ESTHER	ALONSO	GLORIA ESTHER	ALONSO
DIETER	RUIJTEN	DIETER	RUIJTEN
LAURA	TRULLEMANS	LAURA	TRULLEMANS
HILDA	WITTERS	HILDA	WITTERS
VALENTIN	SMEETS	VALENTIN	SMEETS
WALID	BAAZIZ	WALID	BAAZIZ
ERIC	GAIGNEAUX	ERIC	GAIGNEAUX
CÉDRIC	BOISSIÈRE	CEDRIC	BOISSIERE
CLÉMENT	SANCHEZ	CLEMENT	SANCHEZ
JOHANNES	DE VRIES	JOHANNES GERARDUS	DE VRIES
BRIAN	SPIEGELBERG	BRIAN	SPIEGELBERG
TIAN	XIA	TIAN	XIA
ANKE	SPANNENBERG	ANKE	SPANNENBERG
ZHIHONG	WEI	ZHIHONG	WEI
DAVID J C	CONSTABLE	DAVID J	CHICHESTER CONSTABLE
DAVID J	CHICHESTER-CONSTABLE	DAVID J	CHICHESTER CONSTABLE
SABINA	ION	SABINA	ION
ION	SABINA	ION	SABINA
CRISTINA	SORA	CRISTINA	SORA
PAYAL	BAHETI	PAYAL	BAHETI
FREDERIK	WURM	FREDERIK	WURM
STEVEN M	HOWDLE	STEVEN M	HOWDLE
ALVISE	VIVIAN	ALVISE	VIVIAN
CARMELA	APRILE	CARMELA	APRILE
LORAINE	SOUMOY	LORAINE	SOUMOY
LUCA	FUSARO	LUCA	FUSARO
DAMIEN P	DEBECKER	DAMIEN P	DEBECKER
ALEKSANDRA	PEREGUDOVA	ALEKSANDRA	PEREGUDOVA
NATALIYA	BORISOVA	NATALIYA	BORISOVA
DAN	WU	DAN	WU
YESID	HERNÁNDEZ	YESID	HERNANDEZ
DANIEL ANTONIO	AGUILERA	DANIEL ANTONIO	AGUILERA
LAURA	BIRBA	LAURA	BIRBA
MARION	ZWINGELSTEIN	MARION	ZWINGELSTEIN
JEAN-LUC	BESOMBES	JEAN LUC	BESOMBES
CHRISTINE	PIOT	CHRISTINE	PIOT
FRANCESCO LUCA	BASILE	FRANCESCO LUCA	BASILE
VALERIIA	MASLOVA	VALERIIA	MASLOVA
CHIARA	DI MAURO	CHIARA	DI MAURO
DORA	BARNA	DORA	BARNA
DENNIS	WEIDENER	DENNIS	WEIDENER
PHILIPP M	GRANDE	PHILIPP M	GRANDE
HOLGER	KLOSE	HOLGER	KLOSE
HENRIK	GRENMAN	HENRIK	GRENMAN
JUSSI	RISSANEN	JUSSI	RISSANEN
LUCAS	LAGERQUIST	LUCAS	LAGERQUIST
PATRIK	EKLUND	PATRIK	EKLUND
ELINA	LIUS	ELINA	LIUS
MAARIT	LAHTINEN	MAARIT	LAHTINEN
KIRSI	MIKKONEN	KIRSI	MIKKONEN
HANNO C	ERYTHROPEL	HANNO C	ERYTHROPEL
KLAUS	KÜMMERER	KLAUS	KUMMERER
FJODOR	MELNIKOV	FJODOR	MELNIKOV
JULIE B	ZIMMERMAN	JULIE B	ZIMMERMAN
PAUL T	ANASTAS	PAUL T	ANASTAS
SARAH	MONTES	SARAH	MONTES
ARATZ	GENUA	ARATZ	GENUA
BRIGITA	HOCEVAR	BRIGITA	HOCEVAR
LUCIJA	HLADNIK	LUCIJA	HLADNIK
ANA	BJELIC	ANA	BJELIC
EDITA	JASIUKAITYTE GROJZDEK	EDITA	JASIUKAITYTE GROJZDEK
MIHA	GRILC	MIHA	GRILC
BLAZ	LIKOZAR	BLAZ	LIKOZAR
JUHA	AHOLA	JUHA	AHOLA
ATTE	AHO	ATTE	AHO
JANI	KANGAS	JANI	KANGAS
JAY PEE	OÑA	JAY PEE	ONA
IRINA	SIMAKOVA	IRINA	SIMAKOVA
JUHA	TANSKANEN	JUHA	TANSKANEN
SOURABH	MISHRA	SOURABH	MISHRA
KAMAL KISHORE	PANT	KAMAL KISHORE	PANT
YASSER	HARMEN	YASSER	HARMEN
YOUNES	CHHITI	YOUNES	CHHITI
FATIMA EZZAHRAE	M’HAMDI ALAOUI	FATIMA EZZAHRAE	MHAMDI ALAOUI
FOUAD	BENTISS	FOUAD	BENTISS
SOPHIE	DUQUESNE	SOPHIE	DUQUESNE
MOUNIA	ACHAK	MOUNIA	ACHAK
MOHAMED	EL KHOUAKHI	MOHAMED	EL KHOUAKHI
LAURENT	DESHAYESD	LAURENT	DESHAYES
AMINE	MOUNAAM	AMINE	MOUNAAM
MOHAMMED	BENSITEL	MOHAMMED	BENSITEL
ROMAIN	CHEVROT	ROMAIN	CHEVROT
VALERIE	THIERY	VALERIE	THIERY
CAROLINE	SALSANO	CAROLINE	SALSANO
FATOUMATA	TAMBADOU	FATOUMATA	TAMBADOU
SACARIAS	J E PEREANEZ	JUAN ENRIQUE	PEREANEZ SACARIAS
CYRILLE	BARTHELEMY	CYRILLE	BARTHELEMY
SANDRINE	DIDELOT	SANDRINE	DIDELOT
VALERIE	SOPENA	VALERIE	SOPENA
DUSAN	BOSKOVIC	DUSAN	BOSKOVIC
ANGELIKA	EBERHARDT	ANGELIKA	EBERHARDT
ALEXANDER	MENDL	ALEXANDER	MENDL
CARSTEN	CREMERS	CARSTEN	CREMERS
JAN	MAIER	JAN	MAIER
STEFAN	LOEBBECKE	STEFAN	LOEBBECKE
ANA	RODA	ANA	RODA
ANA	M MATIAS	ANA ALEXANDRA	MATIAS
ANA RITA	C DUARTE	ANA RITA C	DUARTE
MANUEL	NUNES DA PONTE	MANUEL	NUNES DA PONTE
M FÁTIMA C GUEDES DA SILVA	C GUEDES DA SILVA	MARIA FATIMA C	GUEDES DA SILVA
ANA	V M NUNES	ANA V M	NUNES
PAULO JOSÉ	ANDRÉ	PAULO JOSE	ANDRE
MAŁGORZATA E	ZAKRZEWSKA	MALGORZATA E	ZAKRZEWSKA
ANDREA	RUIU	ANDREA	RUIU
KARINE	SEAUDEAU-PIROULEY	KARINE	SEAUDEAU PIROULEY
MARIN	SENILA	MARIN	SENILA
THORSTEN	JÄNISCH	THORSTEN	JANISCH
BERNHARD	BAUER-SIEBENLIST	BERNHARD	BAUER SIEBENLIST
GUNNAR	WESTIN	GUNNAR	WESTIN
SARMAD NAIM	KATEA	SARMAD NAIM	KATEA
DUANGAMOL N	TUNGASMITA	DUANGAMOL N	TUNGASMITA
DAVIDE	DI FRANCESCO	DAVIDE	DI FRANCESCO
ABDELHAMID	NEGGAD	ABDELHAMID	NEGGAD
BENOÎT	LOUIS	BENOIT	LOUIS
VALÉRIE	BÉNÉTEAU	VALERIE	BENETEAU
SAMANTHA	MOLINA-GUTIERREZ	SAMANTHA	MOLINA GUTIERREZ
VINCENT	LADMIRAL	VINCENT	LADMIRAL
ROBERTA	BONGIOVANNI	ROBERTA	BONGIOVANNI
CHRISTINE	FRAYRET	CHRISTINE	FRAYRET
CARLO	GATTI	CARLO	GATTI
YANN	DANTEN	YANN	DANTEN
LOUAY	AL HUSSAINI	LOUAY	AL HUSSAINI
ELENA	GALVEZ PARRUCA	MARIA ELENA	GALVEZ PARRUCA
EMELINE	PLACET	EMELINE	PLACET
JULIEN	PINAUD	JULIEN	PINAUD
MOHAMED	EZZEJJARI	MOHAMED	EZZEJJARI
ELMUSTAFA	IBOUSTATEN	ELMUSTAFA	IBOUSTATEN
FENG	NIU	FENG	NIU
YUICHI	NEGISHI	YUICHI	NEGISHI
JOHANN-KILIAN	SCHNOOR	JOHANN KILIAN	SCHNOOR
MARCEL ANDREAS	LIAUW	MARCEL ANDREAS	LIAUW
DAMIEN	BOURGEOIS	DAMIEN	BOURGEOIS
CHRISTINE	CONTINO-PÉPIN	CHRISTINE	CONTINO PEPIN
FATIHA	BENKERROU	FATIHA	BENKERROU
MOSTAPHA	BACHIR BEY	MOSTAPHA	BACHIR BEY
KOMAL	KUMAR	KOMAL	KUMAR
SREEDEVI	UPADHYAYULA	SREEDEVI	UPADHYAYULA
AJAY	TOMER	AJAY	TOMER
BRIGHT T	KUSEMA	BRIGHT T	KUSEMA
CEDRIC	PRZYBYLSKI	CEDRIC	PRZYBYLSKI
JEAN-FRANCOIS	PAUL	JEAN FRANCOIS	PAUL
ANNE	PONCHEL	ANNE	PONCHEL
RINA	GHOSH	RINA	GHOSH
OLIVIER	BACK	OLIVIER	BACK
RÉMY	LEROY	REMY	LEROY
PATRICK	MOREAU	PATRICK	MOREAU
MIKEL	MORVAN	MIKEL	MORVAN
PATRICIA	KRACH	PATRICIA	KRACH
MAGNUS	RUEPING	MAGNUS	RUEPING
JUNHO	CHOI	JUNHO	CHOI
JOAH	HAN	JOAH	HAN
KWANG CHUL	ROH	KWANG CHUL	ROH
JAE-WON	LEE	JAE WON	LEE
HARALD	GRÖGER	HARALD	GROEGER
MICHAEL	STRICKER	MICHAEL	STRICKER
TÂNIA	SINTRA	TANIA E	SINTRA
KARINA	SHIMIZU	KARINA	SHIMIZU
SEISHI	SHIMIZU	SEISHI	SHIMIZU
JOSÉ	CANONGIA LOPES	JOSE	CANONGIA LOPES
ANNA	CHEREPANOVA	ANNA	CHEREPANOVA
VALENTIN	SAPUNOV	VALENTIN	SAPUNOV
EVGENIY	SAVEL'EV	EVGENIY	SAVELEV
LEILA	ALIEVA	LEILA	ALIEVA
LOIC	LECLERCQ	LOIC	LECLERCQ
VERONQIUE	NARDELLO-RATAJ	VERONIQUE	NARDELLO RATAJ
LHOUSSAIN	KROUTZ	LHOUSSAIN	KHROUZ
DAMIEN	CARTIGNY	DAMIEN	CARTIGNY
SOPHIE	VAN SCHOUBROECK	SOPHIE	VAN SCHOUBROECK
DEYANG	ZHAO	DEYANG	ZHAO
BEATRIZ	ROCHA	BEATRIZ	ROCHA
FRANCISCA A	SILVA	FRANCISCA A E	SILVA
MÁRCIA C	NEVES	MARCIA C	NEVES
ANA C A	SOUSA	ANA CATARINA	SOUSA
MOHAMAD REZA	KHODADADI	MOHAMAD REZA	KHODADADI
EMANUELLE L P	FARIA	EMANUELLE L P	FARIA
SELENE	RAMER	SELENE	RAMER
JAKUB	KOSTAL	JAKUB	KOSTAL
KEIICHI	TOMISHIGE	KEIICHI	TOMISHIGE
JESÚS	ESTEBAN	JESUS	ESTEBAN
HELGE	WARMELING	HELGE	WARMELING
ANDREAS J	VORHOLT	ANDREAS J	VORHOLT
KYLIE	LUSKA	KYLIE	LUSKA
SAMI	EL SAYED	SAMI	EL SAYED
MARION	DUVAL	MARION	DUVAL
GHISLAIN	IRAKOZE	GHISLAIN	IRAKOZE
CARLOS	MURILLO	CARLOS	MURILLO
LAURA	DECOSTERD	LAURA	DECOSTERD
MARTINE	URRUTIGOITY	MARTINE	URRUTIGOITY
KARINE	VIGIER	KARINE	DE OLIVEIRA VIGIER
FRANÇOIS	JEROME	FRANCOIS	JEROME
EDUARDO	GARCIA-VERDUGO	EDUARDO	GARCIA VERDUGO
SUJIT	SEN	SUJIT	SEN
MANISHA	MAHARANA	MANISHA	MAHARANA
SVITLANA	FILONENKO	SVITLANA	FILONENKO
LETHIWE	MTHEMBU	LETHIWE	MTHEMBU
BRUNA	DE PAULA SOARES	BRUNA	DE PAULA SOARES
JOSÉ	I GARCÍA	JOSE I	GARCIA
ELÍSABET	PIRES	MARIA ELISABET	PIRES
SIMÃO	P PINHO	SIMAO P	PINHO
HAWRAA	SROUR	HAWRAA	SROUR
RUTURAJSINH M	VALA	RUTURAJSINH M	VALA
HITENDRA M	PATEL	HITENDRA M	PATEL
MAYANK G	SHARMA	MAYANK G	SHARMA
DIVYANAG M	PATEL	DIVYANG M	PATEL
LUKAS	KIPSHAGEN	LUKAS	KIPSHAGEN
LUKAS	VÖMEL	LUKAS	KIPSHAGEN
MARCEL A	LIAUW	MARCEL ANDREAS	LIAUW
CHRISTIAN	KROPF	CHRISTIAN	KROPF
PETER	HAUSOUL	PETER J C	HAUSOUL
GEORGY	DZHABAROV	GEORGY	DZHABAROV
MIKHAIL	VORONOV	MIKHAIL	VORONOV
PHAN DINH	KHA	PHAN DINH	KHA
PAVEL	OREL	PAVEL	OREL
RHONA	SAVIN	RHONA	SAVIN
ROBERT	STOCKMAN	ROBERT	STOCKMAN
STEVE	HOWDLE	STEVE	HOWDLE
JESSICA	GOULD	JESSICA	GOULD
BIN	SUN	BIN	SUN
GÉRARD	BLANCHARD	GERARD	BLANCHARD
SHIBIAO	CHENG	SHIBIAO	CHENG
YINGQI	FAN	YINGQI	FAN
LI	XIE	LI	XIE
YUSHENG	JIANG	YUSHENG	JIANG
MIKEL	AÑIBARRO-ORTEGA	MIKEL	ANIBARRO ORTEGA
JOSÉ	PINELA	JOSE	PINELA
MINGHUI	DONG	MINGHUI	DONG
TÂNIA E	SINTRA	TANIA E	SINTRA
FRANCISCA A E	SILVA	FRANCISCA A E	SILVA
BRUNO	GRIGNARD	BRUNO	GRIGNARD
CHRISTINE	JEROME	CHRISTINE	JEROME
CHRISTOPHE	DETREMBLEUR	CHRISTOPHE	DETREMBLEUR
ANTOINE	BREGE	ANTOINE	BREGE
RAPHAEL	MEREAU	RAPHAEL	MEREAU
TOBIAS	ROBERT	TOBIAS	ROBERT
MOHAMED	LOUTFI	MOHAMED	LOUTFI
JIAN	HE	JIAN	HE
SONG	YANG	SONG	YANG
MONIA RUNGE	NIELSEN	MONIA RUNGE	NIELSEN
THOMAS WILLUM	HANSEN	THOMAS WILLUM	HANSEN
YOHAN	MARTINETTO	YOHAN	MARTINETTO
BRUCE	BEGOT	BRUCE	BEGOT
SEBASTIEN	FLOQUET	SEBASTIEN	FLOQUET
CATHERINE	ROCH	CATHERINE	ROCH
MOHAMED	HAOUAS	MOHAMED	HAOUAS
BETTY	COTTYN-BOITTE	BETTY	COTTYN BOITTE
FRANCK	CAMEREL	FRANCK	CAMEREL
JELENA	JEFTIC	JELENA	JEFTIC
MAX	LINHORST	MAX	LINHORST
DICHAO	SHI	DICHAO	SHI
JEAN-SÉBASTIEN	GIRARDON	JEAN SEBASTIEN	GIRARDON
ANNE	GRIBOVAL-CONSTANT	ANNE	GRIBOVAL CONSTANT
ANNE-SOPHIE	MAMEDE	ANNE SOPHIE	MAMEDE
ERIC	MARCEAU	ERIC	MARCEAU
ANNE-FÉLICIE	LAMIC-HUMBLOT	ANNE FELICIE	LAMIC HUMBLOT
MAYA	MARINOVA	MAYA	MARINOVA
VALÉRIE	BRIOIS	VALERIE	BRIOIS
MOULAY	TAHAR SOUGRATI	MOULAY	TAHAR SOUGRATI
EVAN	PFAB	EVAN	PFAB
ISABELA	SALES	ISABELA	SALES
PEDRO	COSTA	PEDRO	COSTA
SÔNIA	P VENTURA	SONIA P M	VENTURA
SILVANA	MATTEDI	SILVANA	MATTEDI
BETHEL UGOCHUKWU	UKAZU	BETHEL UGOCHUKWU	UKAZU
PILAR	FLORES	PILAR	FLORES
PILAR	HELLÍN	PILAR	HELLIN
MORITZ O	HAUS	MORITZ O	HAUS
FULGENCIO	CONTRERAS	FULGENCIO	CONTRERAS
NEHA	KARANWAL	NEHA	KARANWAL
MALAYIL GOPALAN	SIBI	MALAYIL GOPALAN	SIBI
MARINA	THIERRY	MARINA	THIERRY
AHMED	EL-HARAIRY	AHMED	EL HARAIRY
LÉA	SPITZER	LEA	SPITZER
ANNE	ELAIN	ANNE	ELAIN
MARKUS	HEINRICH	MARKUS R	HEINRICH
LAURA ELENA	HOFMANN	LAURA ELENA	HOFMANN
RICHARD	THOMMERET	RICHARD	THOMMERET
DAVID	FRANCIOLUS	DAVID	FRANCIOLUS
F JOSCHKA	HOLZHÄUSER	FABIAN JOSCHKA	HOLZHAUSER
RENATO	FROIDEVAUX	RENATO	FROIDEVAUX
STEFANIA	MARZORATI	STEFANIA	MARZORATI
RITA	NASTI	RITA	NASTI
ROBERT	TUBA	ROBERT	TUBA
GÁBOR	TURCZEL	GABOR	TURCZEL
MIRAN	IBRAHIM	MIRAN	IBRAHIM
ALICE	DALL'ARMELLINA	ALICE	DALLARMELLINA
STÉPHANIE	CLUZET	STEPHANIE	CLUZET
MIGUEL	A PRIETO	MIGUEL A	PRIETO
RICARDO	CALHELHA	RICARDO C	CALHELHA
SO-YEON	JEONG	SO YEON	JEONG
NING	YAN	NING	YAN
FRÉDÉRIC	BORNETTE	FREDERIC	BORNETTE
PATRICK	JAME	PATRICK	JAME
ANTONIO	HERNANDEZ MANAS	ANTONIO	HERNANDEZ MANAS
VALENTINA	BEGHETTO	VALENTINA	BEGHETTO
BENEDETTA	LEONETTI	BENEDETTA	LEONETTI
SOFIA	CAROLO	SOFIA	CAROLO
ANDREA	MORANDINI	ANDREA	MORANDINI
JULIE	KONG	JULIE	KONG
MATTHIEU	BALAS	MATTHIEU	BALAS
RICHARD	VILLANNEAU	RICHARD	VILLANNEAU
CATARINA	CARVALHO ROCHA	CATARINA	CARVALHO ROCHA
THOMAS	ONFROY	THOMAS	ONFROY
ALEXANDER	SACHSE	ALEXANDER	SACHSE
ALFONSO	RAMIREZ	ALFONSO	RAMIREZ
NIKLAS	VON DER ASSEN	NIKLAS	VON DER ASSEN
JULIAN	EGGER	JULIAN	EGGER
LIAQAT	ALI	LIAQAT	ALI
ARSLAN	AFTAB	ARSLAN	AFTAB
PATRICK	CHOISY	PATRICK	CHOISY
PHILIPPE	DUPAU	PHILIPPE	DUPAU
AHMED	BELOUAZNI	AHMED	BELOUAZNI
ABDELKADER	DOUAOUI	ABDELKADER	DOUAOUI
MOHAMED	LARID	MOHAMED	LARID
HOUCINE	TOUATI	HOUCINE	TOUATI
CATHERINE	BATIOT DUPEYRAT	CATHERINE	BATIOT DUPEYRAT
JEAN MICHEL	TTATIBOUËT	JEAN MICHEL	TATIBOUET
CLAIRE MARIE	PRADIER	CLAIRE MARIE	PRADIER
SERGE	HUBERSON	SERGE	HUBERSON
ETIENNE	SAVARY	ETIENNE	SAVARY
P	JESSOP	PHILIP	JESSOP
T	ZHANG	TAO	ZHANG
THERESA M	REINEKE	THERESA M	REINEKE
MARC	JACQUIN	MARC	JACQUIN
CYRIL	GALLARDO	CYRIL	GALLARDO
AUDREY H	MOORES	AUDREY H	MOORES
JUBRIL	AKOLADE	JUBRIL	AKOLADE
PHILIP	LABUSCHAGNE	PHILIP	LABUSCHAGNE
ANDRI	SWANEPOEL	ANDRI	SWANEPOEL
CAROLINE	LEFEVRE	CAROLINE	LEFEBVRE
AISSA OULD-DRISS	OULD-DRISS	AISSA	OULD DRIS
ANAS	IBEN-AYAD	ANAS	IBEN AYAD
MAARTEN	BARTELS	MAARTEN	BARTELS
FRANÇOIS	FREY	FRANCOIS	FREY
CAROLINE	ROUGER	CAROLINE	ROUGER
PASCAL	TIERCE	PASCAL	TIERCE
BÉRENGÈRE	MENOT	BERENGERE	MENOT
LIQUAN	LI	LIQUAN	LI
YUNFENG	ZHU	YUNFENG	ZHU
GABRIELLE	SCALABRINO	GABRIELLE	SCALABRINO
CYRILLE	BETRON	CYRILLE	BETRON
VÉRONIQUE	BOUNOR-LEGARÉ	VERONIQUE	BOUNOR LEGARE
PHILIPPE	CASSAGNAU	PHILIPPE	CASSAGNAU
MICHELE	BESSON	MICHELE	BESSON
EUGENE	CARMICHAEL	EUGENE	CARMICHAEL
EUGEN	CARMICHAEL	EUGENE	CARMICHAEL
GARY	LYONS	GARY	LYONS
THIERRY	BERNOUD	THIERRY	BERNOUD
PARFAIT	RAMIANDRASOA	PARFAIT	RAMIANDRASOA
HANNES	PUCHER	HANNES	PUCHER
ROLAND	FEINER	ROLAND	FEINER
LISA	ELLMAIER	LISA	ELLMAIER
JAN	DIJKMANS	JAN	DIJKMANS
BEAU	OP DE BEECK	BEAU	OP DE BEECK
JEAN-FRANÇOIS	SASSI	JEAN FRANCOIS	SASSI
FLORIAN	DELRUE	FLORIAN	DELRUE
CÉLINE	HOGNON	CELINE	HOGNON
ANNE	ROUBAUD	ANNE	ROUBAUD
CAPUCINE	DUPONT	CAPUCINE	DUPONT
MAGUELONE	GRATEAU	MAGUELONE	GRATEAU
WOUT	JANSSENS	WOUT	JANSSENS
EKATERINA	MAKSHINA	EKATERINA	MAKSHINA
PIERRE	JACOBS	PIERRE	JACOBS
JEAN-PIERRE	LLORED	JEAN PIERRE	LLORED
SHAOAN	XU	SHAOAN	XU
YUICHI	MANAKA	YUICHI	MANAKA
YUKI	SUNA	YUKI	SUNA
DOROTHEE	LAURENTI	DOROTHEE	LAURENTI
BENOIT	JOFFRES	BENOIT	JOFFRES
CHANTAL	LORENTZ	CHANTAL	LORENTZ
NADÈGE	CHARON	NADEGE	CHARON
ANTOINE	DAUDIN	ANTOINE	DAUDIN
ALAIN	QUIGNARD	ALAIN	QUIGNARD
CHRISTOPHE	GEANTET	CHRISTOPHE	GEANTET
GABRIELA	TATARU	GABRIELA	TATARU
ALICE	BAILLIÉ	ALICE	BAILLIE
KRISTOPHER	ROSADIUK	KRISTOPHER	ROSADIUK
SCOTT	BOHLE	SCOTT	BOHLE
VALERIE	LEJEUNE	VALERIE	LEJEUNE
FRANCESCO	ISAIA	FRANCESCO	ISAIA
NIKOLAOS	XAFENIAS	NIKOLAOS	XAFENIAS
VALERIA	MAPELLI	VALERIA	MAPELLI
JANIS	RIZHIKOVS	JANIS	RIZHIKOVS
PRANS	BRAZDAUSKS	PRANS	BRAZDAUSKS
MARIS	PUKE	MARIS	PUKE
RAMUNAS	TUPCIAUSKAS	RAMUNAS	TUPCIAUSKAS
MARTINS	ANDZS	MARTINS	ANDZS
KRISTINE	MEILE	KRISTINE	MEILE
NIKOLAJS	VEDERNIKOVS	NIKOLAJS	VEDERNIKOVS
AIGARS	PAZE	AIGARS	PAZHE
SANG-HO	CHUNG	SANG HO	CHUNG
PIETER C A	BRUIJNINCX	PIETER C A	BRUIJNINCX
STIJN O M	HINTERDING	STIJN O M	HINTERDING
BERT M	WECKHUYSEN	BERT M	WECKHUYSEN
YOUNG-WUN	KIM	YOUNG WUN	KIM
MOHANAKRISHNA	GUNDA	MOHANAKRISHNA	GUNDA
SUMAN	BJARACHARYA	SUMAN	BAJRACHARYA
SANDIPAM	SRIKANTH	SANDIPAM	SRIKANTH
KAROLIEN	VANBOREKHOVEN	KAROLIEN	VANBROEKHOVEN
TONY	PHAN	TONY	PHAN
ELZBIETA	SKRZYNSKA	ELZBIETA	SKRZYNSKA
SORAYA	ZAID	SORAYA	ZAID
JEAN SÉBASTIEN	GIRARDON	JEAN SEBASTIEN	GIRARDON
MATHILDE	LUNEAU	MATHILDE	LUNEAU
NOLVEN	GUILHAUME	NOLVEN	GUILHAUME
FRÉDÉRIC	MEUNIER	FREDERIC	MEUNIER
YVES	SCHUURMAN	YVES	SCHUURMAN
FIRMIN	OBOUNOU AKONG	FIRMIN	OBOUNOU AKONG
MEHMET NAIL	NASIR	MEHMET NAIL	NASIR
DENNIS	KNOGLER	DENNIS	KNOGLER
ELIAS REGIS	SILVA	ELIAS REGIS	SILVA
IDÁLIA HELENA	ESTEVAM	IDALIA HELENA	ESTEVAM
HANNES	ALEX	HANNES	ALEX
NORBERT	STEINFELDT	NORBERT	STEINFELDT
PATRICK	LOOS	PATRICK	LOOS
JOHN	BARRY	JOHN	BARRY
JORMA	HASSFELD	JORMA	HASSFELD
KAI	LOVIS	KAI	LOVIS
JOHANNES	PLATZEK	JOHANNES	PLATZEK
ALEXANDRE	DÉMOLIS	ALEXANDRE	DEMOLIS
NADINE	ESSAYEM	NADINE	ESSAYEM
CHING SHYA	LEE	CHING SHYA	LEE
YOLANDE	PERES-LUCCHESE	YOLANDE	PERES LUCCHESE
WAN MOHD ASHRI	WAN DAUD	WAN MOHD ASHRI WAN	DAUD
OLIVIER	REYNES	OLIVIER	REYNES
LAURE	LATAPIE	LAURE	LATAPIE
PEKKA	PELJO	PEKKA	PELJO
VERONIQUE	AMSTUTZ	VERONIQUE	AMSTUTZ
HERON	VRUBEL	HERON	VRUBEL
RODRIGO	DE SOUZA	RODRIGO	DE SOUZA
MIHKEL	KOEL	MIHKEL	KOEL
NICK	DAEMS	NICK	DAEMS
XIA	SHENG	XIA	SHENG
YOLANDA	ALVAREZ-GALLEGO	YOLANDA	ALVAREZ GALLEGO
MAREK	TOBISZEWSKI	MAREK	TOBISZEWSKI
STEFAN	TSAKOVSKI	STEFAN	TSAKOVSKI
VASIL	SIMEONOV	VASIL	SIMEONOV
JACEK	NAMIESNIK	JACEK	NAMIESNIK
MICHAEL	KREL	MICHAEL	KREL
ASJA	PETTIGNANO	ASJA	PETTIGNANO
LUCA	BERNARDI	LUCA	BERNARDI
MARIAFRANCESCA	FOCHI	MARIAFRANCESCA	FOCHI
MATTHEW	QUESNE	MATTHEW	QUESNE
EMILY	VAN DEN BERG	EMILY	VAN DEN BERG
SAM	DE VISSER	SAM	DE VISSER
VIVIANE	ROBERT	VIVIANE	ROBERT
ELOÏNE	NPETGAT	ELOINE	NPETGAT
SCHNEIDER	LUDOVIC	SCHNEIDER	LUDOVIC
YASMINA	MEKMOUCHE	YASMINA	MEKMOUCHE
ROUSSELOT PAILLEY	PIERRE	ROUSSELOT PAILLEY	PIERRE
STÉPHANE	MENUEL	STEPHANE	MENUEL
AURÉLIE	MALHO RODRIGUES	AURELIE	MALHO RODRIGUES
AMANDINE	FOULET	AMANDINE	FOULET
HERVÉ	DELEUZE	HERVE	DELEUZE
MARC	BIROT	MARC	BIROT
SIBAO	LIU	SIBAO	LIU
MASAZUMI	TAMURA	MASAZUMI	TAMURA
YOSHINAO	NAKAGAWA	YOSHINAO	NAKAGAWA
NEUS	BLANCH RAGA	NEUS	BLANCH RAGA
ANTONIO EDUARDO	PALOMARES GIMENO	ANTONIO EDUARDO	PALOMARES GIMENO
LUÍS JOAQUÍN	MARTÍNEZ TRIGUERO	LUIS JOAQUIN	MARTINEZ TRIGUERO
FABIENNE	GUILLON	FABIENNE	GUILLON
CÉCILE	BARRON	CECILE	BARRON
RACHELLE	LOOTEN	RACHELLE	LOOTEN
ESTELLE	BONNIN	ESTELLE	BONNIN
CATHERINE	LAPIERRE	CATHERINE	LAPIERRE
ABDELLATIF	BARAKAT	ABDELLATIF	BARAKAT
XAVIER	ROUAU	XAVIER	ROUAU
MARIE-FRANÇOISE	DEVAUX	MARIE FRANCOISE	DEVAUX
DAMIANO	CANI	DAMIANO	CANI
PAOLO P	PESCARMONA	PAOLO P	PESCARMONA
MAXENCE	FACHE	MAXENCE	FACHE
RÉMI	AUVERGNE	REMI	AUVERGNE
BERNARD	BOUTEVIN	BERNARD	BOUTEVIN
JEAN KERIM	NZAMBE TA KEKI	JEAN KERIM	NZAMBE TA KEKI
EFTERPI	VASILIADOU	EFTERPI	VASILIADOU
AURELIEN	PERU	AURELIEN	PERU
FANNY	BRUNISSEN	FANNY	BRUNISSEN
HELENE	THOMAS-GUYON	HELENE	THOMAS GUYON
YINGWEI	LI	YINGWEI	LI
LIYU	CHEN	LIYU	CHEN
HONGLI	LIU	HONGLI	LIU
JILAN	LONG	JILAN	LONG
MOHAMED	BENCHEIKH	MOHAMED	BENCHEIKH
DAMIEN	MILLIASSEAU	DAMIEN	MILLIASSEAU
JON	SOLAR IRAZABAL	JON	SOLAR IRAZABAL
ALEXANDER	LÓPEZ	ALEXANDER	LOPEZ
ISABEL	DE MARCO	ISABEL	DE MARCO
AITZIBER	ADRADOS	AITZIBER	ADRADOS
JON	SOLAR	JON	SOLAR IRAZABAL
AINHOA	HERNÁNDEZ	AINHOA	HERNANDEZ
XAVIER	BANTREIL	XAVIER	BANTREIL
CLÉMENT	FLEITH	CLEMENT	FLEITH
NASREDDINE	KANFAR	NASREDDINE	KANFAR
NICOLAS	GEHIN	NICOLAS	GEHIN
ETHAN	GOLLIARD	ETHAN	GOLLIARD
PAULINE	OHLMANN	PAULINE	OHLMANN
PAULINE	NAVALS	PAULINE	NAVALS
SIMONA	MELLINO	SIMONA	MELLINO
ERIC	CLOT	ERIC	CLOT
JEAN	MARTINEZ	JEAN	MARTINEZ
FRÉDÉRIC	LAMATY	FREDERIC	LAMATY
NANCY	QUARANTA	NANCY	QUARANTA
MARTA	CALIGARIS	MARTA	CALIGARIS
ROMINA	VAROLI	ROMINA	VAROLI
ADRIÁN	CRISTÓBAL	ADRIAN	CRISTOBAL
MAUD	BOLLENBACH	MAUD	BOLLENBACH
MARTINE	SCHMITT	MARTINE	SCHMITT
PATRICK	WAGNER	PATRICK	WAGNER
CHRISTOPHE	SALOMÉ	CHRISTOPHE	SALOME
FRÉDÉRIC	BIHEL	FREDERIC	BIHEL
JEAN-JACQUES	BOURGUIGNON	JEAN JACQUES	BOURGUIGNON
BALA	SUBRAMANIAM	BALA	SUBRAMANIAM
ZHUANZHUAN	XIE	ZHUANZHUAN	XIE
GEOFFREY	AKIEN	GEOFFREY	AKIEN
WENJUAN	YAN	WENJUAN	YAN
ANAND	RAMANATHAN	ANAND	RAMANATHAN
RAGHUNATH	CHAUDHARI	RAGHUNATH	CHAUDHARI
ESTEFANÍA	ZURIAGA	ESTEFANIA	ZURIAGA
ESTHER	SARASA	ESTHER	SARASA
IMANE	BARBARA	IMANE	BARBARA
MARIA FERNANDA	DOS SANTOS MOTA	MARIA FERNANDA	DOS SANTOS MOTA
MARCOAURÉLIO	ALMENARA RODRIGUES	MARCOAURELIO ALMENARA	RODRIGUES
NING	LI	NING	LI
GUANGYI	LI	GUANGYI	LI
JINFAN	YANG	JINFAN	YANG
SHANSHAN	LI	SHANSHAN	LI
FANG	CHEN	FANG	CHEN
XUERU	SHENG	XUERU	SHENG
YU	CONG	YU	CONG
CAROLE	GUYON	CAROLE	GUYON
MARC	BARON	MARC	BARON
ENRIQUE	GARCÍA-BORDEJÉ	ENRIQUE	GARCIA BORDEJE
LAURA	ROLDÁN	LAURA	ROLDAN
CARLOS	DE LA CALLE	CARLOS	DE LA CALLE
MARTA	FABRE	MARTA	FABRE
LISIANNE	DOMON	LISIANNE	DOMON
RÉGIS	DELATOUCHE	REGIS	DELATOUCHE
HERVÉ	ROUILLARD	HERVE	ROUILLARD
NAJLA	FNITER	NAJLA	FNITER
BELSEM	BELKHIRIA	BELSEM	BELKHIRIA
VALÉRIE	THIÉRY	VALERIE	THIERY
ALEJANDRO	LEAL	ALEJANDRO	LEAL DUASO
MATTHIEU	OZAGAC	MATTHIEU	OZAGAC
CÉLINE	BERTINO-GHERA	CELINE	BERTINO GHERA
DOROTHÉE	LAURENTI	DOROTHEE	LAURENTI
MAOBING	TU	MAOBING	TU
ARMANDO	CORDOVA	ARMANDO	CORDOVA
JIANFENG	ZHANG	JIANFENG	ZHANG
GUILLAUME	DE ROBILLARD	GUILLAUME	DE ROBILLARD
JACQUES	ANDRIEU	JACQUES	ANDRIEU
CHARLES	DEVILLERS	CHARLES	DEVILLERS
ANDREA	BASSO	ANDREA	BASSO
ZOHEIR SALIM	BENTOUNSI	ZOHEIR SALIM	BENTOUNSI
CLAIRE	GAREL	CLAIRE	GAREL
BRICE-LOÏC	RENARD	BRICE LOIC	RENARD
PETER	HESEMAN	PETER	HESEMANN
SELIM	KERMASHA	SELIM	KERMASHA
DÉBORA	DÉBORA BIZZO BRUM PEREIRA	DEBORA	BIZZO BRUM PEREIRA
SOPHIE	GUILLAUME	SOPHIE	GUILLAUME
MARC	LAHAYE	MARC	LAHAYE
SAYANI	RAY	SAYANI	RAY
JACQUELINE	VIGOUROUX	JACQUELINE	VIGOUROUX
BERNARD	QUEMENER	BERNARD	QUEMENER
JOSÉ A	MAYORAL	JOSE ANTONIO	MAYORAL
ANTHONY	GARRON	ANTHONY	GARRON
CATHERINE	SANTINI	CATHERINE	SANTINI
PHILIPPE	ARQUILLIÈRE	PHILIPPE	ARQUILLIERE
WALID	AL MAKSOUD	WALID	AL MAKSOUD
CHERIF	LARABI	CHERIF	LARABI
JEAN-JACQUES	WALTER	JEAN JACQUES	WALTER
LUIS	SERRANO	LUIS	SERRANO CANTADOR
BAS	VERKUIJL	BAS	VERKUIJL
AMÉLIA	VIRICEL	AMELIA	VIRICEL
ERIC	PANTE	ERIC	PANTE
MARIUS	PAGEAUD	MARIUS	PAGEAUD
HÉLÈNE	THOMAS-GUYON	HELENE	THOMAS GUYON
LINDA	GOOTJES	LINDA	GOOTJES
JACCO	VAN HAVEREN	JACCO	VAN HAVEREN
DAAN	VAN ES	DAAN	VAN ES
JOHANNES	BITTER	JOHANNES HENDRIK	BITTER
WEN-JUAN	ZHOU	WEN JUAN	ZHOU
LIN	FANG	LIN	FANG
BELEN	ALBELA	BELEN	ALBELA
MARGOT	ALVES	MARGOT	ALVES
MATTHIEU	DUSSAUZE	MATTHIEU	DUSSAUZE
THOMAS	MILINKOVITCH	THOMAS	MILINKOVITCH
MORGANE	DANION	MORGANE	DANION
KARINE	PICHAVANT-RAFINI	KARINE	PICHAVANT RAFINI
MICHAEL	THERON	MICHAEL	THERON
HELENE	THOMASGUYON	HELENE	THOMAS GUYON
STÉPHANE	LEFLOCH	STEPHANE	LE FLOCH
SIMON	DESSET	SIMON	DESSET
HERNÁN ANTONIO	DUARTE	HERNAN ANTONIO	DUARTE
CARLOS RODOLFO	APESTEGUÍA	CARLOS RODOLFO	APESTEGUIA
PIERRE	DAPSENS	PIERRE	DAPSENS
JAVIER	PÉREZ-RAMÍREZ	JAVIER	PEREZ RAMIREZ
CECILIA	MONDELLI	CECILIA	MONDELLI
ISABELLA	GIOVINAZZO	ISABELLA	GIOVINAZZO
MERTEN	MORALES	MERTEN	MORALES
STAVROS	PAPADOKONSTANTAKIS	STAVROS	PAPADOKONSTANTAKIS
XU	MENG	XU	MENG
PEIQING	ZHAO	PEIQING	ZHAO
PERRINE	GERAUDIE	PERRINE	GERAUDIE
LIONEL	CAMUS	LIONEL	CAMUS
VALÉRIE	HUET	VALERIE	HUET
RENEE ISABEL	BAKKEMO	RENEE ISABEL	BAKKEMO
WILLIAM	HELBERT	WILLIAM	HELBERT
JOACHIM BACHMANN	NIELSEN	JOACHIM BACHMANN	NIELSEN
ANKER DEGN	JENSEN	ANKER DEGN	JENSEN
NIELS OLE	KNUDSEN	NIELS OLE	KNUDSEN
CLEMENCE	QUEFFÉLEC	CLEMENCE	QUEFFELEC
BRUNO	BUJOLI	BRUNO	BUJOLI
JACK	LEGRAND	JACK	LEGRAND
MARIANE	AUDO	MARIANE	AUDO
OLIVIER	LEPINE	OLIVIER	LEPINE
MARIA	PARASCHIV	MARIA	PARASCHIV
STEFANO	SFORZA	STEFANO	SFORZA
BARBARA	PRANDI	BARBARA	PRANDI
STEFANIA	BALDASSARRE	STEFANIA	BALDASSARRE
MARCELA	SANTARELLI	MARCELA	SANTARELLI
MONICA	GATTI	MONICA	GATTI
NEHA	BABBAR	NEHA	BABBAR
KATHY	ELST	KATHY	ELST
JUDITH	MUELLER-MAATSCH	JUDITH	MUELLER MAATSCH
GIULIANA	RUBULOTTA	GIULIANA	RUBULOTTA
LAURENT	VEYRE	LAURENT	VEYRE
CHLOÉ	THIEULEUX	CHLOE	THIEULEUX
GNAMIEN-BLA DAVINA	MESSOU	GNAMIEN BLA DAVINA	MESSOU
SURESH KUMAR	RAJU	SURESH KUMAR	RAJU
ARUMUGAM	NATARAJAN	ARUMUGAM	NATARAJAN
ABDULRAHMAN I	ALMANSOUR	ABDULRAHMAN I	ALMANSOUR
CARLOS MENENDEZ	JOSE	CARLOS MENENDEZ	JOSE
LEILA	NEGHADAR	LEILA	NEGHADAR
KAI	SCHUTE	KAI	SCHUTE
LUCA	UTILI	LUCA	UTILI
ROSSELLA	AMADORI	ROSSELLA	AMADORI
FRANCESCA	OSPITALI	FRANCESCA	OSPITALI
JENNY G	VITILLO	JENNY G	VITILLO
ELENA	GROPPO	ELENA	GROPPO
ELISA GIL	BARDAJÍ	ELISA GIL	BARDAJI
MARCELLO	BARICCO	MARCELLO	BARICCO
MICHELE	CHIEROTTI	MICHELE	CHIEROTTI
SILVIA	BORDIGA	SILVIA	BORDIGA
FLORIAN	CHEMARIN	FLORIAN	CHEMARIN
MARWEN	MOUSSA	MARWEN	MOUSSA
CLAIRE	SAULOU	CLAIRE	SAULOU
HENRY-ÉRIC	SPINNLER	HENRY ERIC	SPINNLER
VIOLAINE	ATHES	VIOLAINE	ATHES
MONGI	SEFFEN	MONGI	SEFFEN
AÎDA	KESRAOUI	AIDA	KESRAOUI
ASMA	BEN MABROUK	ASMA	BEN MABROUK
CHALINE	DETONI	CHALINE	DETONI
PEDRO J	MAIRELES TORRES	PEDRO J	MAIRELES TORRES
KAORU	NOBUOKA	KAORU	NOBUOKA
SATOSHI	KITAOKA	SATOSHI	KITAOKA
YUUKI	YAMAMOTO	YUUKI	YAMAMOTO
KAZUYA	HIRANO	KAZUYA	HIRANO
MASAKAZU	TANGE	MASAKAZU	TANGE
YUICHI	ISHIKAWA	YUICHI	ISHIKAWA
GIULIA	FIORANI	GIULIA	FIORANI
ARJAN W	KLEIJ	ARJAN W	KLEIJ
TONY	MUNTER	TONY	MUNTER
NESTOR	SANCHEZ	NESTOR	SANCHEZ
JORGE	BECERRA	JORGE	BECERRA
MIGUEL	CASTELBLANCO	MIGUEL	CASTELBLANCO
BERNAY	CIFUENTES	BERNAY	CIFUENTES
JUTTA	PLÖSSER	JUTTA	PLOSSER
MARTIN	LUCAS	MARTIN	LUCAS
PETER	CLAUS	PETER	CLAUS
PAOLO	RIGHI	PAOLO	RIGHI
PAOLO	ZIOSI	PAOLO	ZIOSI
WOONG	KIM	WOONG	KIM
SEOKHWAN	HWANG	SEOKHWAN	HWANG
BYUNG-GON	RYU	BYUNG GON	RYU
SEUNG GU	SHIN	SEUNG GU	SHIN
KYUNGJIN	CHO	KYUNGJIN	CHO
PANPAN	YANG	PANPAN	YANG
YANQIN	WANG	YANQIN	WANG
QIQI	CUI	QIQI	CUI
ELIAS	FEGHALI	ELIAS	FEGHALI
ALINA	TIRSOAGA	ALINA	TIRSOAGA
BOGDAN	JURCA	BOGDAN	JURCA
ERHARD	KEMNITZ	ERHARD	KEMNITZ
AMEL	BENMEDDAH	AMEL	BENMEDDAH
FANGLI	JING	FANGLI	JING
SÉVERIN	TANOH	SEVERIN	TANOH
FRANÇOIS	BROUST	FRANCOIS	BROUST
JOËL	BLIN	JOEL	BLIN
ANNE	JULBE	ANNE	JULBE
YOHAN	RICHARDSON	YOHAN	RICHARDSON
SIMON	EIBNER	SIMON	EIBNER
YIPING	LUO	YIPING	LUO
JIAN	YI	JIAN	YI
DONGMEI	TONG	DONGMEI	TONG
XING	FU	XING	FU
LIANGFANG	ZHU	LIANGFANG	ZHU
LU	YAO	LU	YAO
JIA	SHI	JIA	SHI
ZHICHENG	JIANG	ZHICHENG	JIANG
JIANMEI	LI	JIANMEI	LI
JUN	WANG	JUN	WANG
XIURU	XUE	XIURU	XUE
JINGYANG	JIANG	JINGYANG	JIANG
ZILIN	JIN	ZILIN	JIN
YANHUA	WANG	YANHUA	WANG
ARMANDO	BORGNA	ARMANDO	BORGNA
DAPENG	LIU	DAPENG	LIU
YAN	LIU	YAN	LIU
DYNA	THENG	DYNA	THENG
GERARD	ARBAT	GERARD	ARBAT
FABIOLA	VILASECA	FABIOLA	VILASECA
BUNTHAN	NGO	BUNTHAN	NGO
JEAN-MARC	MILLET	JEAN MARC	MILLET
OLENA	VOZNIUK	OLENA	VOZNIUK
CRISTIAN	TREVISANUT	CRISTIAN	TREVISANUT
YANN	REBUTEAU	YANN	RABUTEAU
THOMAS	GARCIA	THOMAS	GARCIA
RACHEL	DURAND	RACHEL	DURAND
NATHALIE	IMBERT	NATHALIE	IMBERT
LAURENCE	MURILLO	LAURENCE	MURILLO
VLADIMIR	LEVDANSKY	VLADIMIR	LEVDANSKY
ALEXANDER	LEVDANSKY	ALEXANDER	LEVDANSKY
ISABELLE	DELSARTE	ISABELLE	DELSARTE
PIERRE-EDOUARD	DANJOU	PIERRE EDOUARD	DANJOU
ETIENNE	VEIGNIE	ETIENNE	VEIGNIE
CATHERINE	RAFIN	CATHERINE	RAFIN
ADELINE	RANOUX	ADELINE	RANOUX
LOÏC	LEMIÈGRE	LOIC	LEMIEGRE
GHERARDO	GLIOZZI	GHERARDO	GLIOZZI
ELIZABETH	LACHTER	ELIZABETH	LACHTER
ANNA MARIA	RASPOLLI GALLETTI	ANNA MARIA	RASPOLLI GALLETTI
HILDA	GOMEZ BERNAL	HILDA	GOMEZ BERNAL
MATTIA	MELLONI	MATTIA	MELLONI
SHAOJUAN	ZENG	SHAOJUAN	ZENG
XIANGPING	ZHANG	XIANGPING	ZHANG
HONGSHUAI	GAO	HONGSHUAI	GAO
ZHANG	SUOJIANG	ZHANG	SUOJIANG
MICHAEL	RENZ	MICHAEL	RENZ
AVELINO	CORMA	AVELINO	CORMA
MARTIN	HITZL	MARTIN	HITZL
HA EUN	JEONG	HA EUN	JEONG
DENILSON	SILVA PEREZ	DENILSON	DA SILVA PEREZ
ANDREIA	NUNES	ANDREIA	NUNES
VÉRONIQUE	DUFAUD	VERONIQUE	DUFAUD
MICHAL	NIEWIADOMSKI	MICHAL	NIEWIADOMSKI
JOANNA	GOSCIANSKA	JOANNA	GOSCIANSKA
WOUTER	SCHUTYSER	WOUTER	SCHUTYSER
MOHAMED	AHMAR	MOHAMMED	AHMAR
QUENTIN	GIRKA	QUENTIN	GIRKA
NORBERT	HOFFMANN	NORBERT	HOFFMANN
JEAN	LE BRAS	JEAN	LE BRAS
JACQUES	MUZART	JACQUES	MUZART
WANG	BO	WANG	BO
YANHUI	YANG	YANHUI	YANG
TOM	VAN DEELEN	TOM	VAN DEELEN
KRIJN	DE JONG	KRIJN P	DE JONG
JEAN-MARC	CAMPAGNE	JEAN MARC	CAMPAGNE
RENATA	MARCIA DE FIGUEIREDO	RENATA	MARCIA DE FIGUEIREDO
LAURE	KONNERT	LAURE	KONNERT
HARJINDER	KAUR	HARJINDER	KAUR
HUONG-LY	NGO	HUONG LY	NGO
WASSILA	BENAISSA	WASSILA	BENAISSA
MAURICE	NONUS	MAURICE	NONUS
EMINENCE HONDJUILA	MIOKONO	EMINENCE HONDJUILA	MIOKONO
JULIEN	GARCIA	JULIEN	GARCIA
BRUNO	NARCY	BRUNO	NARCY
ISABELLE	GOSSELIN	ISABELLE	GOSSELIN
INGRID	MURRIETA-PAZOS	INGRID	MURRIETA PAZOS
CHRISTOPHE	TRIQUENAUX	CHRISTOPHE	TRIQUENAUX
KATARINA	FABICOVICOVA	KATARINA	FABICOVICOVA
LISA	UFARTÉ	LISA	UFARTE
GABRIELLE	POTOCKI-VÉRONÈSE	GABRIELLE	POTOCKI VERONESE
WEIJIE	JI	WEIJIE	JI
XINZHEN	FENG	XINZHEN	FENG
BO	SUN	BO	SUN
YAO	YAO	YAO	YAO
QIN	SU	QIN	SU
CHAK-TONG	AU	CHAK TONG	AU
FRÉDÉRIC	NADEAU	FREDERIC	NADEAU
NICOLAS	OGET	NICOLAS	OGET
MICHÈLE	SINDT	MICHELE	SINDT
JOSE ANTONIO	DIAZ	JOSE ANTONIO	DIAZ
VINICIUS OTTONIO	OLIVEIRA GONÇALVES	VINICIUS OTTONIO OLIVEIRA	GONCALVES
SOIZIC	BRILLOUET	SOIZIC	BRILLOUET
SYLVETTE	BRUNET	SYLVETTE	BRUNET
ABIR	DAMMAK	ABIR	DAMMAK
NADÈGE	BEURY	NADEGE	BEURY
MÉGANE	CLÉRET	MEGANE	CLERET
ELISABETH	LAVILLE	ELISABETH	LAVILLE
SOPHIE	BOZONNET	SOPHIE	BOZONNET
GABRIÈLE	VÉRONESE	GABRIELE	VERONESE
GUNEET	KAUR	GUNEET	KAUR
HELEEN	DE WEVER	HELEEN	DE WEVER
ELVIRA	RODRIGUEZ ALONSO	ELVIRA	RODRIGUEZ ALONSO
LAURENT	HEUX	LAURENT	HEUX
JEAN-MICHEL	COMMANDRE	JEAN MICHEL	COMMANDRE
SEBASTIEN	THIERY	SEBASTIEN	THIERY
CHRISTOPHE	GOURDON	CHRISTOPHE	GOURDON
CEDRIC	EPOUNE LINGOME	CEDRIC	EPOUNE LINGOME
VIRGINIE	GOBERT-DEVEAUX	VIRGINIE	GOBERT DEVEAUX
ALEXANDRE	DUMON	ALEXANDRE	DUMON
HARRI	HEIKKINEN	HARRI	HEIKKINEN
REETTA	KAILA	REETTA	KAILA
ANTERO	LAITINEN	ANTERO	LAITINEN
JARI	RÄSÄNEN	JARI	RASANEN
JAN	POLTOWICZ	JAN	POLTOWICZ
NORBERT	WOLAN	NORBERT	WOLAN
RENATA	TOKARZ-SOBIERAJ	RENATA	TOKARZ SOBIERAJ
ANDRZEJ	ADAMSKI	ANDRZEJ	ADAMSKI
JEAN-MARC	PORCHER	JEAN MARC	PORCHER
SANDRINE	ANDRÈS	SANDRINE	ANDRES
AMINA	ALLOUACHE	AMINA	ALLOUACHE
UT DONG	THACH	UT DONG	THACH
NICOLAS	MANIER	NICOLAS	MANIER
ALAIN	GEFFARD	ALAIN	GEFFARD
STÉPHANE	BETOULLE	STEPHANE	BETOULLE
MARC	BONNARD	MARC	BONNARD
JENNIFER	DODSON	JENNIFER	DODSON
RYO	YAMANE	RYO	YAMANE
TEPPEI	OHNISHI	TEPPEI	OHNISHI
CORALIE	QUADRI	CORALIE	QUADRI
ERWAN	LE ROUX	ERWAN	LE ROUX
PATRICK	LOULERGUE	PATRICK	LOULERGUE
MAELLE	GOBIN	MAELLE	GOBIN
JEAN-LUC	AUDIC	JEAN LUC	AUDIC
VANESSA	PREVOT	VANESSA	PREVOT
CLAUDE	FORANO	CLAUDE	FORANO
CHRISTINE	MOUSTY	CHRISTINE	MOUSTY
GHINA	ALI	GHINA	ALI
FLAVIE	SARRAZIN	FLAVIE	SARRAZIN
ALEXANDRE	PINSOLLE-EXTERIEUR	ALEXANDRE	PINSOLLE
JAMES	CLARK	JAMES	CLARK
THOMAS	FARMER	THOMAS	FARMER
MICHAEL	NORTH	MICHAEL	NORTH
IAN	INGRAM	IAN	INGRAM
ROB	MCELROY	ROB	MCELROY
ALICE	SAUNIER	ALICE	SAUNIER
PASCALE	GARCIA	PASCALE	GARCIA
ARMANDO	REANO	FELIX ARMANDO	REANO
MOUANDHOIME	OULAME	MOUANDHOIME	OULAME
JÉRÉMY	REBIERE	JEREMY	REBIERE
FRÉDÉRIC	VIOLLEAU	FREDERIC	VIOLLEAU
ANTOINE	ROUILLY	ANTOINE	ROUILLY
CHARLOTTE	BRUSA	CHARLOTTE	BRUSA
AURORE	CHATRON-COLLIET	AURORE	CHATRON COLLIET
MARJORIE	OCHS	MARJORIE	OCHS
STÉPHANE	BREZILLON	STEPHANE	BREZILLON
YANUSZ	WEGROWSKI	YANUSZ	WEGROWSKI
CAROLINE	RÉMOND	CAROLINE	REMOND
RICHARD	PLANTIER-ROYON	RICHARD	PLANTIER ROYON
CÉDRIC	CABRAL ALMADA	CEDRIC	CABRAL ALMADA
DENILSON	DA SILVA PEREZ	DENILSON	DA SILVA PEREZ
JEAN-FRANCOIS	SASSI	JEAN FRANCOIS	SASSI
GILLES	PELTIER	GILLES	PELTIER
YANNICK	LERAT	YANNICK	LERAT
GWENAELLE	HERVE	GWENAELLE	HERVE
ANTONIO	PINEDA	ANTONIO	PINEDA
ELENI	ILIOPOULOU	ELENI	ILIOPOULOU
PEI SAN	KONG	PEI SAN	KONG
JANINE	LUECKGEN	JANINE	LUECKGEN
RÉGIS	PHILIPPE	REGIS	PHILIPPE
CLAUDE	DE BELLEFON	CLAUDE	DE BELLEFON
CAROLE	CHEVRIN-VILLETTE	CAROLE	CHEVRIN VILLETTE
RUDY	COVIS	RUDY	COVIS
ANTOINE	CRIGNY	ANTOINE	CRIGNY
BLAISE	DUPRE	BLAISE	DUPRE
PHILIPPE	DAVID	PHILIPPE	DAVID
JEAN-PIERRE	PIEROG	JEAN PIERRE	PIEROG
JEAN-CHARLES	DE WEVER	JEAN CHARLES	DE WEVER
FLORIANE	MANGIN	FLORIANE	MANGIN
ESTELLE	BANASZAK-LEONARD	ESTELLE	BANASZAK LEONARD
AGGELIKI	KALOGIANNI	AGGELIKI	KALOGIANNI
CHRYSOULA	MIHAILOF	CHRYSOULA	MICHAILOF
REEM	MOUSELMANI	RIM	MOUSELMANI
ANAÏS	MIRABAUD	ANAIS	MIRABAUD
JEAN-PIERRE	DUTASTA	JEAN PIERRE	DUTASTA
GASTÓN O	LARRAZÁBAL	GASTON O	LARRAZABAL
ANTONIO J	MARTÍN-FERNÁNDEZ	ANTONIO J	MARTIN FERNANDEZ
ANDREEA	DRAGU	ANDREEA	DRAGU
SOLEN	KINAYYIGIT	SOLEN	KINAYYIGIT
SIMONA	COMAN	SIMONA MARGARETA	COMAN
KARINE	PHILIPPOT	KARINE	PHILIPPOT
NICOLAS	THIEBAULT	NICOLAS	THIEBAULT
HANEN	SAGGADI	HANEN	SAGGADI
LIONEL	ESTEL	LIONEL	ESTEL
BERT F	SELS	BERT F	SELS
DAVIDE	ESPOSITO	DAVIDE	ESPOSITO
CHLOE	THIEULEUX	CHLOE	THIEULEUX
CHIARA FRANCESCA	CARROZZA	CHIARA FRANCESCA	CARROZZA
ATTILIO	CITTERIO	ATTILIO	CITTERIO
ROBERTO	SEBASTIANO	ROBERTO	SEBASTIANO
NEJIB	KASMI	NEJIB	KASMI
MUSTAPHA	MAJDOUB	MUSTAPHA	MAJDOUB
ROMAIN	REOCREUX	ROMAIN	REOCREUX
SUSANA	VALENCIA	SUSANA	VALENCIA
GUILLAUME	NOURRY	GUILLAUME	NOURRY
FRANÇOIS	BROUILLETTE	FRANCOIS	BROUILLETTE
RACHIDA	ZERROUKI	RACHIDA	ZERROUKI
MAFALDA R	ALMEIDA	MAFALDA R	ALMEIDA
MARIA V	QUENTAL	MARIA J	QUENTAL
MELISSA V	GOMES	MELISSA V	GOMES
LUCAS	DE CARVALHO	LUCAS	DE CARVALHO
ANA MARIA	FERREIRA	ANA MARIA	FERREIRA
HUGO M D	GOMES	HUGO M D	GOMES
SARA F	CARVALHO	SARA F	CARVALHO
RODRIGO T	NETO	RODRIGO T	NETO
ISABEL	BOAL-PALHEIROS	ISABEL	BOAL PALHEIROS
ISABEL	M MARRUCHO	ISABEL M	MARRUCHO
FELIX ARMANDO	REANO	FELIX ARMANDO	REANO
SANDRA	DOMENEK	SANDRA	DOMENEK
ANNE-MARIE	RIQUET	ANNE MARIE	RIQUET
MARIE-NOELLE	MAILLARD	MARIE NOELLE	MAILLARD
JULIE	CHÉRUBIN	JULIE	CHERUBIN
MENG	ZHAO	MENG	ZHAO
LIMING	HE	LIMING	HE
NURIA	SÁNCHEZ	NURIA	SANCHEZ
ÓSCAR	BENITO-ROMÁN	OSCAR	BENITO ROMAN
MARÍA JOSÉ	COCERO	MARIA JOSE	COCERO
CATARINA	FLORINDO	CATARINA	FLORINDO
GLORIA ESTHER	ALONSO	GLORIA ESTHER	ALONSO
MARÍA	ANDEREZ	MARIA	ANDEREZ
NURIA	SANCHEZ	NURIA	SANCHEZ
OSCAR	BENITO-ROMAN	OSCAR	BENITO ROMAN
ALBERTO	ROMERO	ALBERTO	ROMERO
LEDJANE	SILVA BARRETO	LEDJANE	SILVA BARRETO
IARA	BARBOSA OLIVEIRA	IARA	BARBOSA OLIVEIRA
IARA	GIMENEZ	IARA	GIMENEZ
ANTÔNIO	SOUZA FILHO	ANTONIO	SOUZA FILHO
LUIZ	PEREIRA DA COSTA	LUIZ	PEREIRA DA COSTA
GABRIELA	BORIN BARIN	GABRIELA	BORIN BARIN
VINCENT	VAN DER VLIST	VINCENT	VAN DER VLIST
BEN	VAN DEN BROEK	BEN	VAN DEN BROEK
GUUS	FRISSEN	GUUS	FRISSEN
GERRIT	EGGINK	GERRIT	EGGINK
QI	XIAO	QI	XIAO
CLAIRE	CEBALLOS	CLAIRE	CEBALLOS
GEOFFREY	HIBERT	GEOFFREY	HIBERT
SÉBASTIEN	LECOMMANDOUX	SEBASTIEN	LECOMMANDOUX
OCÉANE	LAMARZELLE	OCEANE	LAMARZELLE
IDELETTE	PLAZANET	IDELETTE	PLAZANET
GUY	COSTA	GUY	COSTA
BENJAMIN	BOËNS	BENJAMIN	BOENS
DANIEL	MONTPLAISIR	DANIEL	MONTPLAISIR
THOMAS	LEBARBÉ	THOMAS	LEBARBE
PIERRE	LARNICOL	PIERRE	LARNICOL
GUY	VERKOEYEN	GUY	VERKOEYEN
JÉRÔME	BLANC	JEROME	BLANC
FILIP	SMEETS	FILIP	SMEETS
GOTTFRIED	EILENBERGER	GOTTFRIED	EILENBERGER
THOMAS	ZWECKMAIR	THOMAS	ZWECKMAIR
LUCIO	MELONE	LUCIO	MELONE
BIANCA	ROSSI	BIANCA	ROSSI
CARLO	PUNTA	CARLO	PUNTA
GEORGETA	POSTOLE	GEORGETA	POSTOLE
THANH-SON	NGUYEN	THANH SON	NGUYEN
PATRICK	GÉLIN	PATRICK	GELIN
LAURENT	PICCOLO	LAURENT	PICCOLO
HUAI YONG	ZHU	HUAI YONG	ZHU
MASAYUKI	SHIRAI	MASAYUKI	SHIRAI
TAKAAKI	HANAOKA	TAKAAKI	HANAOKA
ASHOK KUMAR	VENUGOPAL	ASHOK KUMAR	VENUGOPAL
RAJA	THIRUMALAISWAMY	RAJA	THIRUMALAISWAMY
ASWATHY T	VENUGOPALAN	ASWATHY T	VENUGOPALAN
TAKAYUKI	ISHIZAKA	TAKAYUKI	ISHIZAKA
MAYA	CHATTERJEE	MAYA	CHATTERJEE
ERIKA	FERRARI	ERIKA	FERRARI
ESTEFANIA	ZURIAGA	ESTEFANIA	ZURIAGA
ELISABETTA	ZERAZION	ELISABETTA	ZERAZION
MANUEL	PETROSELLI	MANUEL	PETROSELLI
PAOLA	FRANCHI	PAOLA	FRANCHI
MARCO	LUCARINI	MARCO	LUCARINI
YOSHIHIRO	KON	YOSHIHIRO	KON
TOSHIYUKI	YOKOI	TOSHIYUKI	YOKOI
MASATO	YOSHIOKA	MASATO	YOSHIOKA
KAZUHIKO	SATO	KAZUHIKO	SATO
JOSUA	OBERLERCHNER	JOSUA	OBERLERCHNER
LEANDER	SÜTZL	LEANDER	SUTZL
JOANNA	OLSZÓWKA	JOANNA	OLSZOWKA
EWA	SERWICKA	EWA	SERWICKA
NICOLAS	SOTTO	NICOLAS	SOTTO
MURIEL	BILLAMBOZ	MURIEL	BILLAMBOZ
IMRAN	KHAN	IMRAN	KHAN
ERICA	DUTRA ALBUQUERQUE	ERICA	DUTRA ALBUQUERQUE
ANTONIO ALBERTO	FERNANDES	ANTONIO ALBERTO	FERNANDES
FERNANDO	ARARIPE TORRES	FERNANDO ARARIPE	TORRES
PATRICIA	MACHADO BUENO FERNANDES	PATRICIA	MACHADO BUENO FERNANDES
HASRET	YALGIN	HASRET	YALGIN
PABLO	NAVARRO	PABLO	NAVARRO
MARCOS	LARRIBA	MARCOS	LARRIBA
JULIÁN	GARCÍA	JULIAN	GARCIA
WENHAO	LUO	WENHAO	LUO
M	SANKAR	M	SANKAR
ANDREW	BEALE	ANDREW	BEALE
QIAN	HE	QIAN	HE
CHRISTOPHER	KIELY	CHRISTOPHER	KIELY
GIACOMO MARCO	LARI	GIACOMO MARCO	LARI
VALENTINA	NESE	VALENTINA	NESE
ALESSIA	PADOVANI	ALESSIA	PADOVANI
FRANCISCO	RODRÍGUEZ	FRANCISCO	RODRIGUEZ
ROXAN	JONCOUR	ROXAN	JONCOUR
AMADÉO	FERREIRA	AMADEO	FERREIRA
CÉLINE	TISSERAUD	CELINE	TISSERAUD
CHRISTINE	CANAFF	CHRISTINE	CANAFF
RAPHAËL	CRÉTOIS	RAPHAEL	CRETOIS
JEAN-MARC	CHENAL	JEAN MARC	CHENAL
NICOLE RAYMONDE	DEMARQUETTE	NICOLE RAYMONDE	DEMARQUETTE
MODIBO	MOUNGUENGUI DIALLO	MODIBO	MOUNGUENGUI DIALLO
JÉRÔME	MIJOIN	JEROME	MIJOIN
DENIS	LOURDIN	DENIS	LOURDIN
PAUL	DECAEN	PAUL	DECAEN
ALEXANDRA	TER-HALLE	ALEXANDRA	TER HALLE
EMILIA	STRENG	EMILIA	STRENG
ZACHARIAS	AMARA	ZACHARIAS	AMARA
MICHAEL W	GEORGE	MICHAEL W	GEORGE
MARTYN	POLIAKOFF	MARTYN	POLIAKOFF
BARAA	SIYO	BARAA	SIYO
JULIEN	CLEMENT	JULIEN	COUVREUR
EVELIN	A MANOEL	EVELIN A	MANOEL
DENISE	M G FREIRE	DENISE M G	FREIRE
MARCELA	F P RIBEIRO	MARCELA F P	RIBEIRO
KATARZYNA	PAMIN	KATARZYNA	PAMIN
STEPHANIE	DUPOIRON	STEPHANIE	DUPOIRON
MARION	POMMET	MARION	POMMET
MARIE LAURE	LAMELOISE	MARIE LAURE	LAMELOISE
ROSELLA	SPINA	ROSELLA	SPINA
MOHAMED	SIDI-YKHLEF	MOHAMED	SIDI YKHLEF
LAURA	ARINGHIERI	LAURA	ARINGHIERI
DIANA	IRURETAGOYENA FERRER	DIANA	IRURETAGOYENA FERRER
DAVID	CHADWICK	DAVID	CHADWICK
MILO	SHAFFER	MILO	SHAFFER
GISELA	PELOZO	GISELA	PELOZO
ANDREA	CESARI	ANDREA	CESARI
JUAN C	DOMÍNGUEZ	JUAN C	DOMINGUEZ
NICOLAS	GENEVOIS	NICOLAS	GENEVOIS
NICOLAS	VILLANDIER	NICOLAS	VILLANDIER
VINCENT	CHALEIX	VINCENT	CHALEIX
LOÏC	JAUBERTY	LOIC	JAUBERTY
VINCENT	GLOAGUEN	VINCENT	GLOAGUEN
STÉPHANE	GRELIER	STEPHANE	GRELIER
STÉPHANE	CARLOTTI	STEPHANE	CARLOTTI
KIICHI	FUKUHARA	KIICHI	FUKUHARA
ROBIN	JASTRZEBSKI	ROBIN	JASTRZEBSKI
ROMAIN	LAFON	ROMAIN	LAFON
SANA	LABIDI	SANA	LABIDI
MOUNIR	BEN AMAR	MOUNIR	BEN AMAR
JEAN PHILIPPE	PASSARELLO	JEAN PHILIPPE	PASSARELLO
ANDREÏ	KANAEV	ANDREI	KANAEV
SREEDHAR	GUNDEKARI	SREEDHAR	GUNDEKARI
MARIA	GYNGAZOVA	MARIA	GYNGAZOVA
RUTH	RUIZ	RUTH	RUIZ
CELIA	MERCADER	CELIA	MERCADER
TEDDY	FOURNIER	TEDDY	FOURNIER
PATRICE	GAILLARD	PATRICE	GAILLARD
DOMINIQUE	MILLE	DOMINIQUE	MILLE
DEMIS	FICHET	DENIS	FICHET
NIHAT EGE	SAHIN	NIHAT EGE	SAHIN
JULIEN	KIENER	JULIEN	KIENER
TEKO WILHELMIN	NAPPORN	TEKO WILHELMIN	NAPPORN
KOUAKOU BONIFACE	KOKOH	KOUAKOU BONIFACE	KOKOH
IARA	OLIVEIRA	IARA	BARBOSA OLIVEIRA
MATEUS	SANTOS	MATEUS	SANTOS
INSAF	TOU	INSAF	TOU
YAMINA MOUNIA	AZRI	YAMINA MOUNIA	AZRI
MERIEM	SADI	MERIEM	SADI
NOURREDINE	YASSAA	NOURREDINE	YASSAA
NEENA	ARORA	NEENA	ARORA
LAURA B	HOCH	LAURA B	HOCH
GEOFFREY A	OZIN	GEOFFREY A	OZIN
THOMAS E	WOOD	THOMAS E	WOOD
PAUL G	O'BRIEN	PAUL G	OBRIEN
KRISTINE	LIAO	KRISTINE	LIAO
LAURA M	REYES	LAURA M	REYES
CHARLES A	MIMS	CHARLES A	MIMS
LIONEL	MUNIGLIA	LIONEL	MUNIGLIA
NATHALIE	CLAISSE	NATHALIE	CLAISSE
GUILLAUME	RICOCHON	GUILLAUME	RICOCHON
YING	MA	YING	MA
HELENA	FREITAS	HELENA	FREITAS
MANI	RAJKUMAR	MANI	RAJKUMAR
CHAU	HOANG	CHAU	HOANG
K	SESHAN	K	SESHAN
LEON	LEFFERTS	LEON	LEFFERTS
KOTESWARA	RAO N	NIDADAVOLU	KOTESWARA RAO
AURORE	FILLY	AURORE	FILLY
JONGCHOO	LIM	JONGCHOO	LIM
DOWON	KIM	DOWON	KIM
SEOHYUN	CHO	SEOHYUN	CHO
MYUNG-GIN	LEE	MYUNG GIN	LEE
ANNE-GAËLLE	SICAIRE	ANNE GAELLE	SICAIRE
MARYLINE	VIAN	MARYLINE	VIAN
FRÉDÉRIC	FINE	FREDERIC	FINE
PATRICK	CARRÉ	PATRICK	CARRE
SYLVAIN	TOSTAIN	SYLVAIN	TOSTAIN
FARID	CHEMAT	FARID	CHEMAT
CHRISTINE	RAYNAUD	CHRISTINE	RAYNAUD
NATALIA	CASTRO	NATALIA	CASTRO
PAULO	MORAIS	PAULO	MORAIS
JAIME	COELHO	JAIME	COELHO
CARLOS	AFONSO	CARLOS	AFONSO
VINCENT	BESSE	VINCENT	BESSE
FATOUMATA	CAMARA	FATOUMATA	CAMARA
NICOLAS	ILLY	NICOLAS	ILLY
GHISLAIN	DAVID	GHISLAIN	DAVID
ANOUAR	BEN SAID	ANOUAR	BEN SAID
JEAN-CHRISTOPHE	RUIZ	JEAN CHRISTOPHE	RUIZ
FRÉDÉRIC	CHARTON	FREDERIC	CHARTON
CÉCILE	GUINOT	CECILE	GUINOT
PATRICE	DOLE	PATRICE	DOLE
CATHERINE	JOLY	CATHERINE	JOLY
YVAN	CHALAMET	YVAN	CHALAMET
AIGARS	PAZHE	AIGARS	PAZHE
SVEN	DEWILDE	SVEN	DEWILDE
HEID	BERNAS	HEIDI	BERNAS
YULIYA	DEMIDOVA	YULIYA	DEMIDOVA
NARENDRA	KUMAR	NARENDRA	KUMAR
YOSRA	LARIBI	YOSRA	LARIBI
PHILIPPE	PERRICHON	PHILIPPE	PERRICHON
REKO	LEINO	REKO	LEINO
JIN	QU	JIN	QU
AIDA	KALANTARI	AIDA	KALANTARI
IVAN	MIJAKOVIC	IVAN	MIJAKOVIC
ANNE	GOELZER	ANNE	GOELZER
BAPTISTE	LAUBIE	BAPTISTE	LAUBIE
XIN	ZHANG	XIN	ZHANG
VIVIAN	HOUZELOT	VIVIAN	HOUZELOT
EDOUARD	PLASARI	EDOUARD	PLASARI
AIDA	BANI	AIDA	BANI
GUILLAUME	ECHEVARRIA	GUILLAUME	ECHEVARRIA
JEAN-LOUIS	MOREL	JEAN LOUIS	MOREL
MARIE-ODILE	SIMONNOT	MARIE ODILE	SIMONNOT
KOUOH ELOMBO	FERDINAND	KOUOH ELOMBO	FERDINAND
BERNARD	GRESSIER	BERNARD	GRESSIER
CHAN	ZHEN YI	CHAN	ZHEN YI
NICOLAS	KAMBIA	NICOLAS	KAMBIA
LUYCKX:	MICHEL	LUYCKX:	MICHEL
THIERRY	DINE	THIERRY	DINE
MOHAN	VARKOLU	MOHAN	VARKOLU
SAIKAT	DUTTA	SAIKAT	DUTTA
MARK	MASCAL	MARK	MASCAL
CEDRIC	DEVER	CEDRIC	DEVER
MARIA A	PEDRENO	MARIA A	PEDRENO
JUANA M	BERNAL	JUANA M	BERNAL
JIM	PHILP	JIM	PHILP
ZHANRONG	ZHANG	ZHANRONG	ZHANG
AVTAR	MATHARU	AVTAR	MATHARU
CLAUDIO	CHESI	CLAUDIO	CHESI
QINGLIN	WU	QINGLIN	WU
SHINJI	KUDO	SHINJI	KUDO
TARO	YOKOYAMA	TARO	YOKOYAMA
NOZOMI	GOTO	NOZOMI	GOTO
KOYO	NORINAGA	KOYO	NORINAGA
JUN-ICHIRO	HAYASHI	JUN ICHIRO	HAYASHI
IN TAEK	HWANG	IN TAEK	HWANG
DAL RYE	KIM	DAL RYE	KIM
HEE KYUNG	LIM	HEE KYUNG	LIM
HA YOUNG	SONG	HA YOUNG	SONG
KEE IN	LEE	KEE IN	LEE
MARIE-JOËLLE	MENU	MARIE JOELLE	MENU
MARIE	GRESSIER	MARIE	GRESSIER
JEAN-PIERRE	BONINO	JEAN PIERRE	BONINO
FLORENCE	ANSART	FLORENCE	ANSART
BÉNÉDICTE	RULLIER	BENEDICTE	RULLIER
XAVIER	GARREAU	XAVIER	GARREAU
FRANÇOIS	NAPOLY	FRANCOIS	NAPOLY
CATHERINE	GOUX-HENRY	CATHERINE	GOUX HENRY
LUDIVINE	GERARD JEAN	LUDIVINE	GERARD JEAN
GIADA	MASTRAGOSTINO	GIADA	MASTRAGOSTINO
IVANO	VASSURA	IVANO	VASSURA
SUSANNA	LAROCCA	SUSANNA	LAROCCA
ALBERTO	IACONI	ALBERTO	IACONI
ALESSANDRO	CHIEREGATO	ALESSANDRO	CHIEREGATO
JEAN-LUC	DUBOIS	JEAN LUC	DUBOIS
MAHMUT	ERMEYDAN	MAHMUT	ERMEYDAN
VIVIAN	MERK	VIVIAN	MERK
INGO	BURGERT	INGO	BURGERT
VALENTIN	PARMON	VALENTIN	PARMON
FRANCINE	AGBOSSOU-NIEDERCORN	FRANCINE	AGBOSSOU NIEDERCORN
MARC-ANTOINE	ABADIE	MARC ANTOINE	ABADIE
FLORIAN	MEDINA	FLORIAN	MEDINA
XAVIER	TRIVELLI	XAVIER	TRIVELLI
FRÉDÉRIC	CAPET	FREDERIC	CAPET
ANDRES FELIPE	SIERRA SALAZAR	ANDRES FELIPE	SIERRA SALAZAR
EMMANUEL	MIGNARD	EMMANUEL	MIGNARD
KIM	LARMIER	KIM	LARMIER
CÉLINE	CHIZALLET	CELINE	CHIZALLET
SYLVIE	MAURY	SYLVIE	MAURY
NICOLAS	CADRAN	NICOLAS	CADRAN
ANDRÉ	NICOLLE	ANDRE	NICOLLE
HÉLÈNE	PERNOT	HELENE	PERNOT
SVETLANA	HEYTE	SVETLANA	HEYTE
MARCIA	ARAQUE MARIN	MARCIA CAROLINA	ARAQUE MARIN
JINSOO	KIM	JINSOO	KIM
VICTOR MANUEL	ACEITUNO MELGAR	VICTOR MANUEL	ACEITUNO MELGAR
SEUNG-SOO	KIM	SEUNG SOO	KIM
IWONA	CYBULSKA	IWONA	CYBULSKA
GRZEGORZ	BRUDECKI	GRZEGORZ	BRUDECKI
JONATHAN JED	BROWN	JONATHAN JED	BROWN
METTE H	THOMSEN	METTE H	THOMSEN
JEAN CHRISTOPHE	ROSSI	JEAN CHRISTOPHE	ROSSI
LAURENT	BOITEAU	LAURENT	BOITEAU
LING PHUONG	LUONG	LING PHUONG	LUONG
ANDRÉ	DERATANI	ANDRE	DERATANI
BARBARA	MARET	BARBARA	MARET
CLEMENT	FAYE	CLEMENT	FAYE
GAETANO	CALVARUSO	GAETANO	CALVARUSO
MARCELO DAVID	KAUFMAN RECHULSKI	MARCELO DAVID	KAUFMAN RECHULSKI
FENG	YU	FENG	YU
JOICE	THOMAS	JOICE	THOMAS
STIJN	VAN DE VYVER	STIJN	VAN DE VYVER
MARIO	SMET	MARIO	SMET
CHEN-GUANG	LIU	CHEN GUANG	LIU
LIYANG	LIU	LIYANG	LIU
PETER	FRISTRUP	PETER	FRISTRUP
DIDIER	MARION	DIDIER	MARION
ANNE-LAURE	FAMEAU	ANNE LAURE	FAMEAU
BÉNÉDICTE	BAKAN	BENEDICTE	BAKAN
IMANE	HACHEMI	IMANE	HACHEMI
DMITRY	YU MURZIN	DMITRY	YU MURZIN
CAROLINA	VIEGAS	CAROLINA	VIEGAS
MARIANA	FORTES	MARIANA	FORTES
DEBORA	CHRISTINA	DEBORA	CHRISTINA
DONATO	ARANDA	DONATO	ARANDA
PETER	DEUSS	PETER	DEUSS
MATHIEU	CHIRAT	MATHIEU	CHIRAT
SÉBASTIEN	CLERC	SEBASTIEN	CLERC
FABIEN	GASC	FABIEN	GASC
BRUNO	FOURNEL	BRUNO	FOURNEL
AGNIESZKA	MAGDZIARZ	AGNIESZKA	MAGDZIARZ
JUAN CARLOS	COLMENARES QUINTERO	JUAN CARLOS	COLMENARES QUINTERO
KRZYSZTOF	KURZYDLOWSKI	KRZYSZTOF	KURZYDLOWSKI
JUSTYNA	GRZONKA	JUSTYNA	GRZONKA
OLGA	CHERNYAYEVA	OLGA	CHERNYAYEVA
GUILLAUME	CLAVÉ	GUILLAUME	CLAVE
FRANÇOIS-DIDIER	BOYER	FRANCOIS DIDIER	BOYER
CATHERINE	RAMEAU	CATHERINE	RAMEAU
ANDREW	PARROTT	ANDREW	PARROTT
STEFAN	HILL	STEFAN	HILL
LAURA	RAYMOND	LAURA	RAYMOND
JASON	HINDMARSH	JASON	HINDMARSH
ZEID	ALOTHMAN	ZEID	ALOTHMAN
LICHENG	LIU	LICHENG	LIU
YONGHUA	DU	YONGHUA	DU
BO	WANG	BO	WANG
ZHIHAO	CHEN	ZHIHAO	CHEN
NICOLE	WILDE	NICOLE	WILDE
ROGER	GLÄSER	ROGER	GLASER
HERCULES	CASCON	HERCULES	CASCON
SANTOSH	CHOUDHARY	SANTOSH	CHOUDHARY
VASILEIA - LOUKIA	YFANTI	VASILEIA   LOUKIA	YFANTI
HUNG-YI	HOU	HUNG YI	HOU
SHIN-YU	HUANG	SHIN YU	HUANG
KAROLINE	OSTROWSKI	KAROLINE	OSTROWSKI
THOMAS	SEIDENSTICKER	THOMAS	SEIDENSTICKER
LAKSHMI KANTAM	MANNEPALLI	LAKSHMI KANTAM	MANNEPALLI
JEVGENIJ	LAZKO	JEVGENIJ	LAZKO
LOÏC	POUSSARD	LOIC	POUSSARD
JÉRÔME	MARIAGE	JEROME	MARIAGE
JEAN-MARIE	RAQUEZ	JEAN MARIE	RAQUEZ
PHILIPPE	DUBOIS	PHILIPPE	DUBOIS
IRANTZU	SÁDABA	SADABA ZUBIRI	IRANTZU
IKER	OBREGÓN	IKER	OBREGON
PEDRO LUIS	ARIAS	PEDRO LUIS	ARIAS
BEKKAR	FATIMA	BEKKAR	FATIMA
RUEY-AN	DOONG	RUEY AN	DOONG
HUANG-RU	LIAO	HUANG RU	LIAO
VISHWESH	VENKATRAMAN	VISHWESH	VENKATRAMAN
MAYURI	GUPTA	MAYURI	GUPTA
HALLVARD	SVENDSEN	HALLVARD	SVENDSEN
MARCO	FOSCATO	MARCO	FOSCATO
VIDAR	JENSEN	VIDAR	JENSEN
BJØRN	ALSBERG	BJORN	ALSBERG
MAUD	BENOIT	MAUD	BENOIT
JENNIFER	CHAMPENOIS	JENNIFER	CHAMPENOIS
ANA	LOPEZ CONTRERAS	ANA	LOPEZ CONTRERAS
JULIE	MAGUIRE	JULIE	MAGUIRE
CLAUDIA	BANDINELLI	CLAUDIA	BANDINELLI
MARIA DOLORES	SORIANO	MARIA DOLORES	SORIANO
FRANCESCO	BASILE	FRANCESCO LUCA	BASILE
PATRICIA	CONCEPCIÒN	PATRICIA	CONCEPCION
GIUSEPPE	PUGLIA	GIUSEPPE	PUGLIA
JOSÉ MANUEL	LÒPEZ NIETO	JOSE MANUEL	LOPEZ NIETO
GEORGES THIBAUD	KOUMBA YOYA	GEORGES THIBAUT	KOUMBA YOYA
TATJANA	STEVANOVIC	TATJANA	STEVANOVIC
CRISTINA	SANCHEZ	CRISTINA	SANCHEZ
RODRIGO	LLANO-PONTE	RODRIGO	LLANO PONTE
ISABELLE	DEZ	ISABELLE	DEZ
FABRICE	BISARO	FABRICE	BISARO
ALEXANDRA	FILIPPI	ALEXANDRA	FILIPPI
JOCELYNE	LEVILLAIN	JOCELYNE	LEVILLAIN
ANNIE-CLAUDE	GAUMONT	ANNIE CLAUDE	GAUMONT
P	FONGARLAND	PASCAL	FONGARLAND
F	RATABOUL	FRANCK	RATABOUL
C	DARTIGUELONGUE	C	DARTIGUELONGUE
N	CHARON	NADEGE	CHARON
C	VALLÉE	CHRISTOPHE	VALLEE
W	HNEINE	W	HNEINE
M	ETERNOT	M	ETERNOT
W	HOAREAU	W	HOAREAU
L	CHRIST	LORRAINE	CHRIST
E	CADERBY	E	CADERBY
L	MASSIN	L	MASSIN
CARMEN	ORTIZ-CERVANTES	CARMEN	ORTIZ CERVANTES
JUVENTINO	GARCÍA	JUVENTINO	GARCIA
MARCOS	FLORES-ALAMO	MARCOS	FLORES ALAMO
WUN-CHENG	JHANG	WUN CHENG	JHANG
YIH-WEN	WANG	YIH WEN	WANG
ANDREA	MELE	ANDREA	MELE
FRANCESCO	TROTTA	FRANCESCO	TROTTA
FABRIZIO	CALDERA	FABRIZIO	CALDERA
DOMINIQUE	SCALARONE	DOMINIQUE	SCALARONE
FRANCA	CASTIGLIONE	FRANCA	CASTIGLIONE
MONICA	FERRO	MONICA	FERRO
BARBARA	ROSSI	BARBARA	ROSSI
JIAOQI	GAO	JIAOQI	GAO
WENJIE	YUAN	WENJIE	YUAN
CHUANG	XUE	CHUANG	XUE
GUANGQING	DU	GUANGQING	DU
SHANG-TIAN	YANG	SHANG TIAN	YANG
JELKA	DIEDENHOVEN	JELKA	DIEDENHOVEN
CHRISTOPHER	JENSEN	CHRISTOPHER	JENSEN
HELMUT	GEHRKE	HELMUT	GEHRKE
GRÉGOIRE	AUDO	GREGOIRE	AUDO
CÉLINE	LE QUEMENER	CELINE	LE QUEMENER
OLATUNDE	JOGUNOLA	OLATUNDE	JOGUNOLA
VALERIE	ETA	VALERIE	ETA
MATTIAS	HEDENSTRÖM	MATTIAS	HEDENSTROM
OLA	SUNDMAN	OLA	SUNDMAN
ANNE-SOPHIE	BURLOT	ANNE SOPHIE	BURLOT
REZZOUG	SID-AHMED	REZZOUG	SID AHMED
MAACHE-REZZOUG	ZOULIKHA	MAACHE REZZOUG	ZOULIKHA
MAUGARD	THIERRY	MAUGARD	THIERRY
VINCENT	SOL	VINCENT	SOL
AYMÉS	ALBUQUERQUE BUYS GONÇALVES	AYMES	ALBUQUERQUE BUYS GONCALVES
KAREN	SIGNORI PEREIRA	KAREN	SIGNORI PEREIRA
ERICK	COELHO ROCHA	ERICK	COELHO ROCHA
LIDIA	GODINA	LIDIA	GODINA
ALEXEY	KIRILIN	ALEXEY	KIRILIN
ANTON	TOKAREV	ANTON	TOKAREV
BHANU CHANDRA	MAREPALLY	BHANU CHANDRA	MAREPALLY
CLAUDIO	AMPELLI	CLAUDIO	AMPELLI
CHIARA	GENOVESE	CHIARA	GENOVESE
GEORGIA	PAPANIKOLAOU	GEORGIA	PAPANIKOLAOU
LIJIE	CHEN	LIJIE	CHEN
DUODUO	WU	DUODUO	WU
ADRIAAN	VAN DEN BRUINHORST	ADRIAAN	VAN DEN BRUINHORST
MAAIKE C	KROON	MAAIKE C	KROON
MARIANNE A B J	BECKERS	MARIANNE A B J	BECKERS
ZDENEK	TISLER	ZDENEK	TISLER
ALICE	MEULLEMIESTRE	ALICE	MEULLEMIESTRE
RICHARD	CAPART	RICHARD	CAPART
AMMAR	BENSAKHRIA	AMMAR	BENSAKHRIA
MARC-PHILIPP	RUBY	MARC PHILIPP	RUBY
WALTER	PANZERI	WALTER	PANZERI
LOREDANO	POLLEGIONI	LOREDANO	POLLEGIONI
NATASA	NOVAK TUSAR	NATASA	NOVAK TUSAR
MANUEL	OJEDA	MANUEL	OJEDA
NIKA	OSTERMAN	NIKA	OSTERMAN
LJUDMILA	FELE ZILNIK	LJUDMILA	FELE ZILNIK
ANTON	MEDEN	ANTON	MEDEN
MATJAZ	MAZAJ	MATJAZ	MAZAJ
JAMES	J LEACHY	JAMES J	LEAHY
WITOLD	KWAPINSKI	WITOLD	KWAPINSKI
FRANCIS	BOUGIE	FRANCIS	BOUGIE
WANNA	WONDEMAGEGN	WANNA	WONDEMAGEGN
MAHAMOUD ABDOULKARIM	AHMED	MAHAMOUD ABDOULKARIM	AHMED
FATIMA	EL BAHHAJ	FATIMA	EL BAHHAJ
ANNE JULIETTE	TROUILLER	ANNE JULIETTE	TROUILLER
JOELLE	ROCHE	JOELLE	ROCHE
LAETITIA	PRESTOZ	LAETITIA	PRESTOZ
EMILIE	EVANNO	EMILIE	EVANNO
EMILE	BERE	EMILE	BERE
CHAU	KAR YEE	CHAU	KAR YEE
ERGYS	PAHIJA	ERGYS	PAHIJA
ADITI	BHASIN	ADITI	BHASIN
CHI-WAI	HUI	CHI WAI	HUI
WOOJIN	BACK	WOOJIN	BACK
SANGHYO	KIM	SANGHYO	KIM
JASMINE	DEVADHASAN	JASMINE	DEVADHASAN
PASCALE	DE CARO	PASCALE	DE CARO
SOPHIE	THIEBAUD ROUX	SOPHIE	THIEBAUD ROUX
ANAIS	GODARD	ANAIS	GODARD
EMELINE	VEDRENNE	EMELINE	VEDRENNE
ZÉPHIRIN	MOULOUNGUI	ZEPHIRIN	MOULOUNGUI
MAX	CARDENAS-FERNANDEZ	MAX	CARDENAS FERNANDEZ
GARY J	LYE	GARY J	LYE
FABIANA	SUBRIZI	FABIANA	SUBRIZI
CHARLOTTE E M	BENNETT	CHARLOTTE E M	BENNETT
PENUMATHSA K V	BHARAT	PENUMATHSA K V	BHARAT
HELEN C	HAILES	HELEN C	HAILES
TOM D	SHEPPARD	TOM D	SHEPPARD
DAVID J	LEAK	DAVID J	LEAK
CLEO	KONTORAVDI	CLEO	KONTORAVDI
NILAY	SHAH	NILAY	SHAH
ANTONINO	FAMULARI	ANTONINO	FAMULARI
GUIDO	RAOS	GUIDO	RAOS
STEFANO VALDO	MEILLE	STEFANO VALDO	MEILLE
GIOVANNI BATTISTA	APPETECCHI	GIOVANNI BATTISTA	APPETECCHI
STEFANO	PASSERINI	STEFANO	PASSERINI
JEAN JACQUE	WALTER	JEAN JACQUES	WALTER
KAI	SZETO	KAI	SZETO
PHILIPPE	ARQUILLIERE	PHILIPPE	ARQUILLIERE
ALDA LISA	CONCIA	ALDA LISA	CONCIA
JALILA	SIMAAN	JALILA	SIMAAN
MARIUS	REGLIER	MARIUS	REGLIER
SOŇA	GARAJOVA	SONA	GARAJOVA
BRUNO	GUGLIARELLI	BRUNO	GUIGLIARELLI
MARIA ROSA	BECCIA	MARIA ROSA	BECCIA
FRÉDÉRIC	BIASO	FREDERIC	BIASO
HELEN	HAILES	HELEN C	HAILES
TOM	SHEPPARD	TOM D	SHEPPARD
PAUL	DALBY	PAUL	DALBY
JOHN	WARD	JOHN	WARD
GARY	LYE	GARY J	LYE
AKSHAY	PATEL	AKSHAY	PATEL
MARIA	VILLEGAS-TORRES	MARIA	VILLEGAS TORRES
JOSÉ	ASSAF	JOSE MANSUR	ASSAF
AMANDA	S DAMASCENO	AMANDA S	DAMASCENO
CÍNTHIA	S CASTRO	CINTHIA S	CASTRO
JOSÉ	M ASSAF	JOSE MANSUR	ASSAF
MICHAEL	DIERKS	MICHAEL	DIERKS
MARCELO	RECHULSKI	MARCELO DAVID	KAUFMAN RECHULSKI
ELISABETE M	ASSAF	ELISABETE M	ASSAF
FRANCISCO G E	NOGUEIRA	FRANCISCO GUILHERME ESTEVES	NOGUEIRA
HUDSON W P	CARVALHO	HUDSON W P	CARVALHO
KONSTANTINOS	TRIANTAFYLLIDIS	KONSTANTINOS	TRIANTAFYLLIDIS
POLYKARPOS	LAZARIDIS	POLYKARPOS	LAZARIDIS
THOMAS	PINNAVAIA	THOMAS	PINNAVAIA
MIRA	DAOUD ATTIEH	MIRA	DAOUD ATTIEH
AUDE	FALCIMAIGNE-CORDIN	AUDE	FALCIMAIGNE CORDIN
KARSTEN	HAUPT	KARSTEN	HAUPT
S V	LUIS	SANTIAGO V	LUIS
VIRGINIE	BELLIÈRE-BACA	VIRGINIE	BELLIERE BACA
PATRICK	REY	PATRICK	REY
SARAVANAMURUGAN	SHUNMUGAVEL	SARAVANAMURUGAN	SHUNMUGAVEL
DEBORA MORAIS	BEZERRA	DEBORA MORAIS	BEZERRA
ALESSANDRA F	LUCREDIO	ALESSANDRA F	LUCREDIO
LÉO-PAUL	VAURS	LEO PAUL	VAURS
SONIA	HEAVEN	SONIA	HEAVEN
CHARLES	BANKS	CHARLES	BANKS
CLOTILDE	GAILLARD	CLOTILDE	GAILLARD
MARIA	BOLTOEVA	MARIA	BOLTOEVA
SYLVIA	GEORG	SYLVIA	GEORG
VALÉRIE	MAZAN	VALERIE	MAZAN
DARIIA	TERNOVA	DARIIA	TERNOVA
ALEXANDER	TURANOV	ALEXANDER	TURANOV
ALEXANDRA	MANSUR	ALEXANDRA	MANSUR
ZELIA	LOBATO	ZELIA	LOBATO
ROMAN	MATTHESSEN	ROMAN	MATTHESSEN
INE	ROMBOUTS	INE	ROMBOUTS
IVO	STASSEN	IVO	STASSEN
TREES	DE BAERDEMAEKER	TREES	DE BAERDEMAEKER
DIEDERIK	DEPLA	DIEDERIK	DEPLA
JAN	DELCOUR	JAN	DELCOUR
JULIANA ARRIEL	TORRES	JULIANA ARRIEL	TORRES
PRICILA MARIA BATISTA	CHAGAS	PRICILA MARIA BATISTA	CHAGAS
FRANCISCO GUILHERME ESTEVES	NOGUEIRA	FRANCISCO GUILHERME ESTEVES	NOGUEIRA
MARIA CRISTINA	SILVA	MARIA CRISTINA	SILVA
ANGELITA DUARTE	CORRÊA	ANGELITA DUARTE	CORREA
TATIANA FREITAS	SILVA	TATIANA FREITAS	SILVA
THAISA	MATOS	THAISA	MATOS
JOSÉ MANSUR	ASSAF	JOSE MANSUR	ASSAF
RYSZARD	GRABOWSKI	RYSZARD	GRABOWSKI
JOANNA	KRYSCIAK-CZERWENKA	JOANNA	KRYSCIAK CZERWENKA
RAFAEL	MANSUR	RAFAEL	MANSUR
FABIO	RAMANERY	FABIO	RAMANERY
IVAN ALBERTO	SANDOVAL SALAZAR	IVAN ALBERTO	SANDOVAL SALAZAR
DARLIS ADRIANA	VARON CARDENAS	DARLIS ADRIANA	VARON CARDENAS
ROSA CRISTINA	VITORINO DE PAULA	ROSA CRISTINA	VITORINO DE PAULA
YORDANKA	REYES CRUZ	YORDANKA	REYES CRUZ
DONATO ALEXANDRE	GOMES ARANDA	DONATO ALEXANDRE	GOMES ARANDA
GISEL	DIAZ	GISEL	DIAS
MARIE	GUILLOT	MARIE	GUILLOT
JEAN-MICHEL	COMMANDRÉ	JEAN MICHEL	COMMANDRE
STÉPHANE	PELLET-ROSTAING	STEPHANE	PELLET ROSTAING
FRÉDÉRIC	GOETTMANN	FREDERIC	GOETTMANN
MERCEDES	MORENO-RECIO	MERCEDES	MORENO RECIO
JOSEFA	MÉRIDA-ROBLES	JOSEFA	MERIDA ROBLES
SHEKHAR	SHARMA	SHEKHAR	SHARMA
FERNANDA	MEDEIROS	FERNANDA	MEDEIROS
SYLVANIA	PUTRI	SYLVANIA	PUTRI
ELSA	KRISANTI	ELSA	KRISANTI
NASRUDDIN	NASRUDDIN	NASRUDDIN	NASRUDDIN
AURIANE	FREYBURGER	AURIANE	FREYBURGER
YAQING	DUAN	YAQING	DUAN
CORDT	ZOLLFRANK	CORDT	ZOLLFRANK
HAOQUAN	LI	HAOQUAN	LI
JIANXIA	ZHENG	JIANXIA	ZHENG
DAVID	BEZIER	DAVID	BEZIER
THOMAS	DOMBRAY	THOMAS	DOMBRAY
LUIS C	MISAL CASTRO	LUIS C	MISAL CASTRO
BEATA	MICHALKIEWICZ	BEATA	MICHALKIEWICZ
AGNIESZKA	WRÓBLEWSKA	AGNIESZKA	WROBLEWSKA
JACEK	MLODZIK	JACEK	MLODZIK
EDYTA	MAKUCH	EDYTA	MAKUCH
HIROYUKI	MATSUDA	HIROYUKI	MATSUDA
YUKI	NAKAZATO	YUKI	NAKAZATO
YOSHIHIRO	INOUE	YOSHIHIRO	INOUE
KIYOFUMI	KURIHARA	KIYOFUMI	KURIHARA
KATSUMI	TOCHIGI	KATSUMI	TOCHIGI
MAUD	CHEMIN	MAUD	CHEMIN
SUMIN	LEE	SUMIN	LEE
BYEONGJO	KIM	BYEONGJO	KIM
KYUYONG	CHOI	KYUYONG	CHOI
HYEONSHIN	LEE	HYEONSHIN	LEE
ANNA	KALLIOLA	ANNA	KALLIOLA
TAPIO	VEHMAS	TAPIO	VEHMAS
TIINA	LIITIÄ	TIINA	LIITIA
TARJA	TAMMINEN	TARJA	TAMMINEN
YAOCIHUATL	MEDINA-GONZALEZ	YAOCIHUATL	MEDINA GONZALEZ
AHMED	JARRAY	AHMED	JARRAY
SEVERINE	CAMY	SEVERINE	CAMY
JEAN-STÉPHANE	CONDORET	JEAN STEPHANE	CONDORET
M I	BURGUETE	MARIA ISABEL	BURGUETE
BELEN	ALTAVA	BELEN	ALTAVA
RITA	COSTA	RITA	COSTA
MARA G FREIRE	FREIRE	MARA G	FREIRE
SALIHA	DAAS AMIOUR	SALIHA	DAAS AMIOUR
OURIDA	ALLOUI-LOMBARKIA	OURIDA	ALLOUI LOMBARKIA
LEILA	HAMBABA	LEILA	HAMBABA
KIKI A	KURNIA	KIKI A	KURNIA
SMAIN	CHEMAT	SMAIN	CHEMAT
SOUHILA	KHORSI LABOUKHI	SOUHILA	KHORSI LABOUKHI
KAMEL	DAOUD	KAMEL	DAOUD
URSZULA	NARKIEWICZ	URSZULA	NARKIEWICZ
ANTONI W	MORAWSKI	ANTONI W	MORAWSKI
RAFAL J	WRÓBEL	RAFAL J	WROBEL
SHARDA	KONDAWAR	SHARDA	KONDAWAR
REMI	CAZELLES	REMI	CAZELLES
JÉRÔME	LENOTRE	JEROME	LE NOTRE
KYUNG-RAN	HWANG	KYUNG RAN	HWANG
JINSUK	LEE	JINSUK	LEE
JEONG SIK	HAN	JEONG SIK	HAN
IL-HO	CHOI	IL HO	CHOI
LUCILIA SOUSA	RIBEIRO	LUCILIA SOUSA	RIBEIRO
MANUEL FERNANDO RIBEIRO	PEREIRA	MANUEL FERNANDO RIBEIRO	PEREIRA
JOSÉ JOAQUIM DE MELO	ÓRFÃO	JOSE JOAQUIM DE MELO	ORFAO
SANDRO	GENNEN	SANDRO	GENNEN
BERNARD	GILBERT	BERNARD	GILBERT
CHRISTINE	JÉRÔME	CHRISTINE	JEROME
DAVID	ALAIMO	DAVID	ALAIMO
JULIEN	DE WINTER	JULIEN	DE WINTER
PASCAL	GERBAUX	PASCAL	GERBAUX
MONICA	NARDI	MONICA	NARDI
MANUELA	OLIVERIO	MANUELA	OLIVERIO
GIOVANNI	SINDONA	GIOVANNI	SINDONA
ANTONIO	PROCOPIO	ANTONIO	PROCOPIO
MIKE	GEORGE	MICHAEL W	GEORGE
SAMUEL	MILLER	SAMUEL	MILLER
RAPHAEL	HORVATH	RAPHAEL	HORVATH
EDWARD	RAYNER	EDWARD	RAYNER
DAVID	DUPONT	DAVID	DUPONT
NATIVITAD	HERRERA CANO	NATIVIDAD	HERRERA CANO
PAOLA	COSTANZO	PAOLA	COSTANZO
ANTONIO	DE NINO	ANTONIO	DE NINO
LOREDANA	MAIUOLO	LOREDANA	MAIUOLO
RÉMY	LAUNEZ	REMY	LAUNEZ
ISABELLE	BILLAULT	ISABELLE	BILLAULT
MARIE-CHRISTINE	SCHERRMANN	MARIE CHRISTINE	SCHERRMANN
JORIS	ROOSEN	JORIS	ROOSEN
STEVEN	MULLENS	STEVEN	MULLENS
CHANGHUI	LIU	CHANGHUI	LIU
SALIM	FERDJANI	SALIM	FERDJANI
ZEINEDINE	DJEGHABA	ZEINEDDINE	DJEGHABA
SAULI	VUOTI	SAULI	VUOTI
GIOVANNI	FAVA	GIOVANNI	FAVA
MARIA DOMENICA	DI MAURO	MARIA DOMENICA	DI MAURO
MARCELLA	SPAMPINATO	MARCELLA	SPAMPINATO
DANIELA	BIONDI	DANIELA	BIONDI
GIOVANNI	CENTONZE	GIOVANNI	CENTONZE
RICCARDO	MAGGIORE	RICCARDO	MAGGIORE
NICOLA	D'ANTONA	NICOLA	DANTONA
MARIA GRAZIA	SAITA	MARIA GRAZIA	SAITA
BARBARA	MELILLI	BARBARA	MELILLI
MARIO	ANDRONICO	MARIO	ANDRONICO
DANILO	ALEO	DANILO	ALEO
RAFFAELE	MORRONE	RAFFAELE	MORRONE
SONIA	PEDOTTI	SONIA	PEDOTTI
FATIHA	DERGAL	FATIHA	DERGAL
ILHAM	MOKBEL	ILHAM	MOKBEL
JACQUES	JOSE	JACQUES	JOSE
MARIYA	PETROVA	MARIYA	PETROVA
DOAA	OSMAN	DOAA	OSMAN
ASHRAF	ASHMAWY	ASHRAF	ASHMAWY
MAHER	NESSIM	MAHER	NESSIM
ALI	EL BASSOUSSI	ALI	EL BASSOUSSI
SELAIMIA-FERDJANI	OUASSILA	SELAIMIA FERDJANI	OUASSILA
KENJI	TAKAHASHI	KENJI	TAKAHASHI
RYOHEI	KAKUCHI	RYOHEI	KAKUCHI
YOSHIKI	SHIBATA	YOSHIKI	SHIBATA
MAKOTO	YAMAGUCHI	MAKOTO	YAMAGUCHI
KAZUAKI	NINOMIYA	KAZUAKI	NINOMIYA
CAMILA CRISTANE	CORDEIRO	CAMILA CRISTANE	CORDEIRO
RAQUEL JULIANA	ROMO BUCHELLY	RAQUEL JULIANA	ROMO BUCHELLY
IMENE	SEHOUT	IMENE	SEHOUT
ABDELMADJID	DEBACHE	ABDELMADJID	DEBACHE
JOSÉ ANTONIO	MAYORAL	JOSE ANTONIO	MAYORAL
MARIANA	SILVA	MARIANA	SILVA
ROSA	DE PAULA	ROSA CRISTINA	VITORINO DE PAULA
IVAN	SALAZAR	IVAN ALBERTO	SANDOVAL SALAZAR
YORDANKA	CRUZ	YORDANKA	REYES CRUZ
CRISTIANE	DA SILVA	CRISTIANE	DA SILVA
GISEL	DIAS	GISEL	DIAS
JUSTYNA	MAJEWSKA	JUSTYNA	MAJEWSKA
JUNG HOON	PARK	JUNG HOON	PARK
HONG JOO	LEE	HONG JOO	LEE
LUIGI	DA VIA	LUIGI	DA VIA
THOMAS EDWARD	DAVIES	THOMAS EDWARD	DAVIES
CARLO	RECCHI	CARLO	RECCHI
DONG WON	HWANG	DONG WON	HWANG
MARIUS	PRASPALIAUSKAS	MARIUS	PRASPALIAUSKAS
NERIJUS	PEDISIUS	NERIJUS	PEDISIUS
NAZZOLY	RUEDA	NAZZOLY	RUEDA
RODRIGO	TORRES	RODRIGO	TORRES
CLAUDIA	ORTIZ	CLAUDIA	ORTIZ
OVEIMAR	BARBOSA	OVEIMAR	BARBOSA
ROBERTO	FERNANDEZ-LAFUENTE	ROBERTO	FERNANDEZ LAFUENTE
LUCIANA	R B GONÇALVES	LUCIANA R B	GONCALVES
JUSTO	PEDROCHE	JUSTO	PEDROCHE
MARIA	DEL MAR YUST	MARIA	DEL MAR YUST
MARIA	DEL CARMEN MILLÁN-LINARES	MARIA	DEL CARMEN MILLAN LINARES
RAFAEL	C RODRIGUES	RAFAEL C	RODRIGUES
ALBERTO	SANCHEZ	ALBERTO	SANCHEZ
REYNALDO	VILLALONGA	REYNALDO	VILLALONGA
CHEN	ZHE-NING	CHEN	ZHE NING
HAO	HU	HAO	HU
CHAN	KWONG-YU	CHAN	KWONG YU
LIANGXU	XIE	LIANGXU	XIE
YOUNG SUG	KIM	YOUNG SUG	KIM
SUN MIN	KIM	SUN MIN	KIM
CATHERINE	BONNAFOUS	CATHERINE	BONNAFOUS
GUADALUPE	VACA MEDINA	GUADALUPE	VACA MEDINA
LAURE	CANDY	LAURE	CANDY
GÉRARD	VILAREM	GERARD	VILAREM
TIM	DEN HARTOG	TIM	DEN HARTOG
JÜRGEN	KLANKERMAYER	JURGEN	KLANKERMAYER
THORSTEN	VOM STEIN	THORSTEN	VOM STEIN
SPAS	STOYCHEV	SPAS	STOYCHEV
KASSEM	BEYDOUN	KASSEM	BEYDOUN
KATHARINA	THENERT	KATHARINA	THENERT
GHAZI	GHATTAS	GHAZI	GHATTAS
RICARDO	SANTOS	RICARDO	SANTOS
BRUNO	GODINHO	BRUNO	GODINHO
NUNO	GAMA	NUNO	GAMA
RUI	SILVA	RUI	SILVA
ARTUR	FERREIRA	ARTUR	FERREIRA
OLIVIA	CONDASSAMY	OLIVIA	CONDASSAMY
CÉDRIC	FISHMEISTER	CEDRIC	FISCHMEISTER
SHILIN	HUANG	SHILIN	HUANG
HALLOUMA	BILEL	HALLOUMA	BILEL
NACEUR	HAMDI	NACEUR	HAMDI
FETHI	ZAGROUBA	FETHI	ZAGROUBA
MARCELA	P F RIBEIRO	MARCELA F P	RIBEIRO
JOSÉ CLEITON	S DOS SANTOS	JOSE CLEITON S	DOS SANTOS
ALESSANDRO	B C SIMAS	ALESSANDRO B C	SIMAS
MARIA ALICE	Z COELHO	MARIA ALICE	ZARUR COELHO
ANGELO	A T DA SILVA	ANGELO A T	DA SILVA
JULIA	M ROBERT	JULIA M	ROBERT
ANTONIO	C O MACHADO	ANTONIO C O	MACHADO
ALINE	M CASTRO	ALINE M	CASTRO
ALICE	COGNIGNI	ALICE	COGNIGNI
KATHARINA	BICA	KATHARINA	BICA
PETER	GÄRTNER	PETER	GARTNER
RONALD	ZIRBS	RONALD	ZIRBS
CHRISTIAN	SCHRÖDER	CHRISTIAN	SCHRODER
HERWIG	PETERLIK	HERWIG	PETERLIK
NOURA	TOUAHRI	NOURA	TOUAHRI
AMEL	BENADDA	AMEL	BENADDA
AKILA	BARAMA	AKILA	BARAMA
MARCELA	FRANÇA PENNA RIBEIRO	MARCELA F P	RIBEIRO
ALFONSO	YÉPEZ	ALFONSO	YEPEZ
ANTONIO A	ROMERO	ANTONIO ANGEL	ROMERO REYES
SIHEM	DRIAI	SIHEM	DRIAI
C	COUTANCEAU	CHRISTOPHE	COUTANCEAU
ANNA	ZALINEEVA	ANNA	ZALINEEVA
STÈVE	BARANTON	STEVE	BARANTON
MARIO	SIMOES	MARIO	SIMOES
MARTINA	C C PINTO	MARTINA C C	PINTO
JOSE CLEITON	S DOS SANTOS	JOSE CLEITON S	DOS SANTOS
JOSÉ CARLOS	PINTO	JOSE CARLOS	PINTO
SERGIO	SOPEÑA DE FRUTOS	SERGIO	SOPENA DE FRUTOS
CARMEN	MARTÍN	CARMEN	MARTIN
NACERA	LAHOUEL BENABBES	NACERA	LAHOUEL BENABBES
OMAR	KHEROUA	OMAR	KHEROUA
IBRAHIM ELKHALIL	HAJ MESAOUD	IBRAHIM ELKHALIL	HAJ MESAOUD
SARA	LAHOUEL	SARA	LAHOUEL
ABDULLAH	AL-MAJID	ABDULLAH	AL MAJID
ASSEM M	BARAKAT	ASSEM M	BARAKAT
HANY J	AL-NAJAR	HANY J	AL NAJJAR
SYED F	ADIL	SYED F	ADIL
VIJAY H	MASAND	VIJAY H	MASAND
HAZEM A	GHABBOUR	HAZEM A	GHABBOUR
HOONG-KUN	FUN	HOONG KUN	FUN
JEONG-HOON	KIM	JEONG HOON	KIM
SANG-HOON	HAN	SANG HOON	HAN
CHAE-YOUNG	PARK	CHAE YOUNG	PARK
SYLWIA	WASKIEWICZ	SYLWIA	WASKIEWICZ
EWELINA	DYBALSKA	EWELINA	DYBALSKA
MALGORZATA	BUREK	MALGORZATA	BUREK
HENNING	KUHZ	HENNING	KUHZ
KLAUS-DIETER	VORLOP	KLAUS DIETER	VORLOP
ANTJE	HEVERKERL	ANTJE	HEVEKERL
DAGMAR	HOFMANN	DAGMAR	HOFMANN
JOSEFA	HOFMANN	JOSEFA	HOFMANN
MARKUS R	HEINRICH	MARKUS R	HEINRICH
MRUTYUNJAY	PANIGRAHI	MRUTYUNJAY	PANIGRAHI
DMYTRO	KOZAK	DMYTRO	KOZAK
MARIUSZ	GRABDA	MARIUSZ	GRABDA
ETSURO	SHIBATA	ETSURO	SHIBATA
TAKASHI	NAKAMURA	TAKASHI	NAKAMURA
MANGESH	AVHAD	MANGESH	AVHAD
JORGE MARIO	MARCHETTI	JORGE MARIO	MARCHETTI
MARCOS	SANCHEZ	MARCOS	SANCHEZ
ELISA	PEÑA	ELISA	PENA
MERCEDES	MARTINEZ	MERCEDES	MARTINEZ
JOSÉ	ARACIL	JOSE	ARACIL
NAZZOLY	BRÜNIG	NAZZOLY	BRUNIG
RUDOLF	PIETSCHNIG	RUDOLF	PIETSCHNIG
HOANG VU	LY	HOANG VU	LY
HEE CHUL	WOO	HEE CHUL	WOO
LEONARD JAMES	WRIGHT	LEONARD JAMES	WRIGHT
NABILAH	ISMAIL	NABILAH	ISMAIL
TERRENCE	COLLINS	TERRENCE	COLLINS
NARESH	SINGHAL	NARESH	SINGHAL
ISABEL	VICENTE	ISABEL	VICENTE
STEFANO	PROTO	STEFANO	PROTO
SERGIO	CASTILLÓN	SERGIO	CASTILLON
DAILY	RODRÍGUEZ PADRÓN	DAILY	RODRIGUEZ PADRON
ANTONIO ANGEL	ROMERO REYES	ANTONIO ANGEL	ROMERO REYES
CARMEN	LASTRES	CARMEN	LASTRES
ALINA M	BALU	ALINA MARIANA	BALU
MAHMOUD	TRABELSI	MAHMOUD	TRABELSI
KHALED	MLIKI	KHALED	MLIKI
DAN	BELOSINSCHI	DAN	BELOSINSCHI
CLAUDE	JOLIVALT	CLAUDE	JOLIVALT
NOÉMIE	BALISTRERI	NOEMIE	BALISTRERI
ILONA	WANDZIK	ILONA	WANDZIK
MARTA	KOWALCZYK	MARTA	KOWALCZYK
MAÏTÉ	AUDEMAR	MAITE	AUDEMAR
FEI	LUI	FEI	LUI
SALVADORA	ORTEGA-REQUENA	SALVADORA	ORTEGA REQUENA
SERGE	REBOUILLAT	SERGE	REBOUILLAT
NASSIM	SAYOUD	NASSIM	SAYOUD
TATIANA	CUCU	TATIANA	CUCU
BRUNO	DE MEULENAER	BRUNO	DE MEULENAER
AFSANEH	FEIZ	AFSANEH	FEIZ
AYOOB	BAZGIR	AYOOB	BAZGIR
ABIRAMI	DEVADAS	ABIRAMI	DEVADAS
THOMAS	JAUBERT	THOMAS	JAUBERT
JEANNE-ROSE	VALÉRIE	JEANNE ROSE	VALERIE
A	DUFFY	A	DUFFY
S	PENET	S	PENET
EDOUARD	BAILLE-BARRELLE	EDOUARD	BAILLE BARRELLE
JEAN-CHRISTOPHE	HENRION	JEAN CHRISTOPHE	HENRION
XAVIER	SCHULTZE	XAVIER	SCHULTZE
JULIEN	PORTAL	JULIEN	PORTAL
CHARLES	GOMES	CHARLES	GOMES
GAUTHIER	JARROUSSE	GAUTHIER	JARROUSSE
CAROLINE	JOLY	CAROLINE	JOLY
MIREILLE	ARNAUD-ROUX	MIREILLE	ARNAUD ROUX
VÉRONIQUE	VALERO	VERONIQUE	VALERO
CLAUDINE	MOIRE	CLAUDINE	MOIRE
FABIENNE	ROYOU-BOUTIN	FABIENNE	ROYOU BOUTIN
THIERRY	BORDIER	THIERRY	BORDIER
PATRICIO	GUERREIRO	PATRICIO	GUERREIRO
MAGALI	LIMA	MAGALI	LIMA
SERGE	RICHARD	SERGE	RICHARD
JAAKKO	HILTUNEN	JAAKKO	HILTUNEN
DAVID	YAP	DAVID	YAP
JEAN-MICHEL	TATIBOUET	JEAN MICHEL	TATIBOUET
A	SIMPSON	A	SIMPSON
STÉPHANE	STREIFF	STEPHANE	STREIFF
PATRICK	MAESTRO	PATRICK	MAESTRO
JEAN-LUC	MOULLET	JEAN LUC	MOULLET
A	KOVACS	A	KOVACS
F	TOUCHARD	F	TOUCHARD
L	CHOCINSKI	L	CHOCINSKI
