original_firstname	original_lastname	first_name	family_name
TAO	ZHANG	NA	NA
HAILE	CAI	NA	NA
CHANGZHI	LI	NA	NA
AIQIN	WANG	NA	NA
MARK	GARRETT	NA	NA
GARY	SHELDRAKE	NA	NA
JEAN-PAUL	LANGE	NA	NA
JEROEN VAN	BUIJTENEN	NA	NA
LETICIA ESPINOSA	ALFONSO	NA	NA
WOUTER	SPIERING	NA	NA
ROB	POLMANS	NA	NA
BENJAMIN	KATRYNIOK	NA	NA
CARSTEN	LIEBIG	NA	NA
CYRILLE	GUILLON	NA	NA
SÉBASTIEN	PAUL	NA	NA
WOLFGANG F	HOELDERICH	NA	NA
FRANK	DUMEIGNIL	NA	NA
MARC	SUTTER	NA	NA
MARC	LEMAIRE	NA	NA
ESTELLE	METAY	NA	NA
YANN	RAOUL	NA	NA
ALESSANDRO	CHIEREGATO	NA	NA
FRANCESCO	BASILE	NA	NA
FABRICIO	CAVANI	NA	NA
PATRICIA	CONCEPCION	NA	NA
GIUSEPPE	LIOSI	NA	NA
VÉRONIQUE	NARDELLO-RATAJ	NA	NA
LOIC	LECLERCQ	NA	NA
ADRIEN	MOURET	NA	NA
BING	HONG	NA	NA
ROBERTO	COMPANY	NA	NA
PIERRE	BAUDUIN	NA	NA
ANNA	PROUST	NA	NA
JEAN-MARIE	AUBRY	NA	NA
WERNER	KUNZ	NA	NA
FUWEI	LI	NA	NA
XIA	CHUNGU	NA	NA
PEIQING	ZHAO	NA	NA
MAUD	CHEMIN	NA	NA
ANNE-LAURE	WIROTIUS	NA	NA
FRÉDÉRIQUE	HAM-PICHAVANT	NA	NA
DENILSON DA	SILVA-PEREZ	NA	NA
MICHEL	PETIT-CONIL	NA	NA
GILLES	LABAT	NA	NA
BENOIT	GADENNE	NA	NA
CARINE	ALFOS	NA	NA
HENRI	CRAMAIL	NA	NA
STÉPHANE	GRELLER	NA	NA
VALÉRIE	MOLINIER	NA	NA
AURÉLIE	LAVERGNE	NA	NA
LAURIANNE	MOITY	NA	NA
JONATHAN	LAI	NA	NA
MATHIEU	SAUTHIER	NA	NA
ANDRÉ	MORTREUX	NA	NA
WOUTER	SCHUTYSER	NA	NA
STIJN VAN DE	VYVER	NA	NA
MICHIEL	DUSSELIER	NA	NA
JAN	GEBOERS	NA	NA
BERT	SELS	BERT F	SELS
DAMIEN	DELCROIX	NA	NA
CHRISTOPHE	VALLÉE	NA	NA
DIDIER	BERNARD	NA	NA
OLIVIA	CHAUMET-MARTIN	NA	NA
EMMANUELLE	PELLIER	NA	NA
P	CALLEJA	NA	NA
JOSEPH A	STEWART	NA	NA
ERIK	REUBSAET	NA	NA
BERT M	WECKHUYSEN	BERT M	WECKHUYSEN
PIETER C A	BRUIJNINCX	PIETER C A	BRUIJNINCX
INAKI	GANDARIAS	NA	NA
SARA G	FERNANDEZ	NA	NA
PEDRO L	ARIAS	NA	NA
RAJA	ZNAIGUIA	NA	NA
PATRICK	REY	NA	NA
JEAN-MARC	MILLET	NA	NA
STÉPHANE	LORIDANT	NA	NA
PIERRICK	GAUDIN	NA	NA
BENDAOU	NOHAIR	NA	NA
SERGE	KALIAGUINE	NA	NA
MATTHIEU O	SONNATI	NA	NA
SONIA	AMIGONI	NA	NA
ELISABETH P TAFFIN DE	GIVENCHY	NA	NA
THIERRY	DARMANIN	NA	NA
OLIVIER	CHOULET	NA	NA
FRÉDÉRIC	GUITTARD	NA	NA
E	NELHIG	NA	NA
L	MOTTE	NA	NA
E	GUENIN	NA	NA
HENNING	KAYSER	NA	NA
WALTER	LEITNER	NA	NA
PABLO DOMINGUEZ DE	MARIA	NA	NA
NATHALIE	TANCHOUX	NA	NA
YULIA	MONAKHOVA	NA	NA
PIERRE	AGULHON	NA	NA
DIDIER	TICHIT	NA	NA
FRANÇOISE	QUIGNARD	NA	NA
GRIT	STRAGANZ	NA	NA
AGNÈS	ROLLAND-SABATÉ	NA	NA
ROMAIN	IRAGUE	NA	NA
ALAIN	BULÉON	NA	NA
LAURENCE	TARQUIS	NA	NA
JEAN-LOUIS	DOUBLIER	NA	NA
BERNARD	RIEDL	NA	NA
VAHÉ	VARDANYAN	NA	NA
ALIREZA	KABOORANI	NA	NA
BOUDDAH	POATY	NA	NA
GREGORY	CHAUVE	NA	NA
ALEXANDRU	CUREA	NA	NA
MADALINA	TUDORACHE	NA	NA
SIMONA M	COMAN	NA	NA
VASILE	PARVULESCU	NA	NA
KAMEH	TAJVIDI	NA	NA
JENS U	OLTMANNS	NA	NA
LEILA	NEGAHDAR	NA	NA
REGINA	PALKOVITS	NA	NA
SYLVAIN	CAILLOL	NA	NA
RÉMI	AUVERGNE	NA	NA
BERNARD	BOUTEVIN	NA	NA
NORBERT	STEINFELDT	NA	NA
BARAA	SIYO	NA	NA
JOHAN DE	CONINCK	NA	NA
CHRISTOPHE	LUGUEL	NA	NA
PETER	MIEDZIAK	NA	NA
HAMED	ALSHAMMARI	NA	NA
DAVID	WILLOCK	NA	NA
DAVID	KNIGHT	NA	NA
GRAHAM	HUTCHINGS	NA	NA
PHILIP	JESSOP	NA	NA
CANDACE	FOWLER	NA	NA
CATHERINE	OÂNEILL	NA	NA
XIN	SU	NA	NA
JULIEN	PINAUD	NA	NA
ERICA	KOWAL	NA	NA
MICHAEL	CUNNINGHAM	NA	NA
YVES	QUENEAU	NA	NA
JIA-NENG	TAN	NA	NA
MOHAMMED	AHMAR	NA	NA
EMELINE	PRANDATO	NA	NA
FRANÇOISE	MÉCHIN	NA	NA
ROBERTO	OLCESE	NA	NA
BINOD	SHRESTHA	NA	NA
MOHAMMED	BETTAHAR	NA	NA
DOMINIQUE	PETITJEAN	NA	NA
ANTHONY	DUFOUR	NA	NA
CHARLIE	BASSET	NA	NA
SANDRA	CONSTANT	NA	NA
JEAN-CHARLES	MOTTE	NA	NA
ABDELATIF	BARAKAT	NA	NA
CLAIRE	DUMAS	NA	NA
FRENCESCO DI	RENZO	NA	NA
FRANÇOIS	NAPOLY	NA	NA
BRUNO	ANDRIOLETTI	NA	NA
MICHELINE	DRAYE	NA	NA
LUDIVINE	JEAN-GÉRARD	NA	NA
CATHERINE	GOUX-HENRY	NA	NA
CLAUDIO	AGUIAR	NA	NA
ANTONIO	BAPTISTA	NA	NA
JULIANNA SOUZA	SARTORI	NA	NA
ALINE	BIGATON	NA	NA
TALITA	ZOCCA	NA	NA
MICHELE	CATELAN	NA	NA
NATHALIA	CORREA	NA	NA
FENG	WANG	NA	NA
FREDERIC	HAPIOT	NA	NA
JEROME	BOULANGER	NA	NA
HERVÉ	BRICOUT	NA	NA
ANNE	PONCHEL	NA	NA
ERIC	MONFLIER	NA	NA
THOMAS	LEBARBÉ	NA	NA
LISE	MAISONNEUVE	NA	NA
SALVADOR	ORDONEZ	NA	NA
EVA	DIAZ	NA	NA
MATTEO	GUIDOTTI	NA	NA
CRISTINA	TIOZZO	NA	NA
RINALDO	PSARO	NA	NA
FABIO	CARNIATO	NA	NA
ALESSANDRO	GALLO	NA	NA
FRÉDÉRIC	BATAILLE	NA	NA
JACQUES	BARBIER	NA	NA
FABIENNE	PERRONA	NA	NA
ALEXANDRE	BRIAND	NA	NA
ISABELLE	POLAERT	NA	NA
MARIANA CUNHA	FELIX	NA	NA
MÉLISSA	FORNASERO	NA	NA
STÉPHANE	MARCOTTE	NA	NA
LIONEL	ESTEL	NA	NA
RUDY	COVIS	NA	NA
JUSTINE	GIAUFFRET	NA	NA
IRENE NOTAR	FRANCESCO	NA	NA
JENNIFER K	EDWARDS	NA	NA
GRAHAM J	HUTCHINGS	NA	NA
SYLVAIN	ANTONIOTTI	NA	NA
HARESH	MANYAR	NA	NA
CHRISTOPHE	COUTANCEAU	NA	NA
MATHIEU	MOUGENOT	NA	NA
PASCAL	BRAULT	NA	NA
MARIO	SIMOES	NA	NA
STÈVE	BARANTON	NA	NA
ERIC DA	SILVA	NA	NA
WISSAM	DAYOUB	NA	NA
JULIEN	DEBRAY	NA	NA
GÉRARD	MIGNANI	NA	NA
ARJAN	KLEIJ	NA	NA
CHRIS	WHITEOAK	NA	NA
FELIU	MASERAS	NA	NA
AINARA	NOVA	NA	NA
PAOLO P	PESCARMONA	PAOLO P	PESCARMONA
SYED M	AL-AMSYAR	NA	NA
CHRISTOPHER J	WHITEOAK	NA	NA
ARJAN W	KLEIJ	ARJAN W	KLEIJ
HICHAM	AITRASS	NA	NA
NADINE	ESSAYEM	NA	NA
MICHÈLE	BESSON	NA	NA
IRANTZU	SADABA	NA	NA
MANUEL	OJEDA	NA	NA
RAFAEL	MARISCAL	NA	NA
MANUEL LOPEZ	GRANADOS	NA	NA
IKER	AGIRREZABAL-TELLERIA	NA	NA
MARTINO	NIEDDU	NA	NA
ESTELLE	GARNIER	NA	NA
BERNARD	KUREK	NA	NA
FRANCK-DOMINIQUE	VIVIEN	NA	NA
CHRISTOPHE	BLIARD	NA	NA
ALI	YOUSSEF	NA	NA
JEAN-PIERRE	LLORED	NA	NA
N	FERLIN	NA	NA
S	GATARD	NA	NA
S	BOUQUILLON	NA	NA
MASAZUMI	TAMURA	NA	NA
KAIYOU	CHEN	NA	NA
YASUSHI	AMADA	NA	NA
YOSHINAO	NAKAGAWA	NA	NA
KELLCHI	TOMISHIGE	NA	NA
SARAVANAMURUGAN	SHUNMUGAVEL	NA	NA
ANDERS	RIISAGER	NA	NA
CHRISTOPHE	LEN	NA	NA
ESTELLE BANASZAK	LEONARD	NA	NA
NICOLAS	DRILLAUD	NA	NA
ISABELLE	PEZRON	NA	NA
HOUCINE	MHEMDI	NA	NA
JOHANNES	NIEDERHAUSER	NA	NA
SARAH	PRATTER	NA	NA
PRAKASH	SAHOO	NA	NA
YOUNG-NAM	JANG	NA	NA
SEUNG-WOO	LEE	NA	NA
HUIHUI	LIU	NA	NA
XIAN	ZHANG	NA	NA
GUIYING	LI	NA	NA
CHANGWEI	HU	NA	NA
TOMAS VAN	HAASTERECHT	NA	NA
CARL C I	LUDDING	NA	NA
KRIJN P DE	JONG	NA	NA
JOHANNES H	BITTER	NA	NA
MARGARIDA COSTA	GOMES	NA	NA
PASCALE	HUSSON	NA	NA
AGILIO	PADUA	NA	NA
KAZUHIKO	ISHIKAWA	NA	NA
MAGDALENA	TITIRICI	NA	NA
ALEKSEY	BYCHKOV	NA	NA
FREDERIQUE	BERTAUD	NA	NA
ARNAUD	AUBIGNY	NA	NA
CHRISTELLE	BOUCHERAND	NA	NA
MARIE	BESSIERES	NA	NA
OLIVIER	GUERRINI	NA	NA
RÉMI	CAZELLES	NA	NA
ANNE	GALARNEAU	NA	NA
VINCENT	BESSE	NA	NA
B	BLAS-MOLINOS	NA	NA
S	WESSELBAUM	NA	NA
U	HINTERMAIR	NA	NA
G	FRANCIO	NA	NA
W	LEITNER	NA	NA
VÉRONIQUE	DUFAUD	NA	NA
BASTIEN	CHATELET	NA	NA
LIONEL	JOUCLA	NA	NA
JEAN-PIERRE	DUTASTA	NA	NA
ALEXANDRE	MARTINEZ	NA	NA
JULIEN	LECLAIRE	NA	NA
DANIEL	STELLWAGEN	NA	NA
KRIJN DE	JONG	NA	NA
JOHANNES	BITTER	NA	NA
AMANDINE	FOULET	NA	NA
HERVÉ	DELEUZE	NA	NA
GUIDO	SONNEMANN	NA	NA
PHILIPPE	GARRIGUES	NA	NA
MARTINE	LARGERON	NA	NA
JOSÉ	FRAILE	NA	NA
ENRIQUE	GARCIA-BORDEJÉ	NA	NA
LAURA	ROLDAN	NA	NA
FRANCK	LAUNAY	NA	NA
RITA	SASSINE	NA	NA
CATARINA	ROCHA	NA	NA
MICHAEL	RAMIN	NA	NA
THOMAS	ONFROY	NA	NA
ROBERT	GOSSELINK	NA	NA
DANIËL	STELLWAGEN	NA	NA
HARRY	BITTER	NA	NA
ANNA	KULIK	NA	NA
ANGELA	KÖCKRITZ	NA	NA
ANDREAS	MARTIN	NA	NA
ARNO	BEHR	NA	NA
PAVEL	HORÁK	NA	NA
HYNEK	BENE	NA	NA
XAVIER	FROGNEUX	NA	NA
OLIVIER	JACQUET	NA	NA
CHRISTOPHE	GOMES	NA	NA
THIBAULT	CANTAT	NA	NA
MAEVA	GIRAUDO	NA	NA
PHILIPPE	BOUCHARD	NA	NA
WOUTER DE	SOETE	NA	NA
CAMILLE	LUDOT	NA	NA
BORIS	ESTRINE	NA	NA
JEAN	LEBRAS	NA	NA
SINISA	MARINKOVIC	NA	NA
JACQUES	MUZART	NA	NA
JUSSI	RISSANEN	NA	NA
HENRIK	GRENMAN	NA	NA
STEFAN	WILLFÖR	NA	NA
DMITRY	MURZIN	NA	NA
TAPIO	SALMI	NA	NA
FLORA T T	NG	NA	NA
JIN KU	CHO	NA	NA
KEVIN VAN	GEEM	NA	NA
SOPHIE	GUILLAUME	NA	NA
J	BIDANGE	NA	NA
C	FISCHMEISTER	NA	NA
C	BRUNEAU	NA	NA
FELIX	RICHTER	NA	NA
TIM	KLASEN	NA	NA
LAILA	SAHRAOUI	NA	NA
FERDI	SCHÜTH	NA	NA
MICKA	AGACH	NA	NA
IONNA	MELIDI	NA	NA
VÉRONIQUE	RATAJ	NA	NA
BOHAN	ZHAO	NA	NA
YAN	ZENG	NA	NA
DONGMEI	TONG	NA	NA
LOURDES	BALLINAS-CASARRUBIAS	NA	NA
TANIA	SAUCEDO	NA	NA
LAILA	MUNOZ-CASTELLANOS	NA	NA
VIRGINIA	NEVAREZ-MOORILLON	NA	NA
GUILLERMO	GONZALEZ-SANCHEZ	NA	NA
OLATUNDE	JOGUNOLA	NA	NA
JYRI-PEKKA	MIKKOLA	NA	NA
ISABELLE	CAPRON	NA	NA
FANCH	CHERHAL	NA	NA
HERVÉ	CATHALA	NA	NA
BERNARD	CATHALA	NA	NA
CAPUCINE	DUPONT	NA	NA
TIMOTHÉE	NOCQUET	NA	NA
JEAN-MICHEL	COMMANDRÉ	NA	NA
MAGUELONE	GRATEAU	NA	NA
SYLVAIN	SALVADOR	NA	NA
PURAN SINGH	RATHORE	NA	NA
SONAL	THAKORE	NA	NA
FEI	LIU	NA	NA
KARINE DE OLIVEIRA	VIGIER	NA	NA
JEAN-MARC	CLACENS	NA	NA
FLORYAN	DECAMPO	NA	NA
FRANÇOIS	JÉRÔME	NA	NA
KÉVIN	LOUIS	NA	NA
LAURENCE	VIVIER	NA	NA
YANNICK	POUILLOUX	NA	NA
JIE	YANG	NA	NA
MINGHAO	LI	NA	NA
BINGHUA	ZHOU	NA	NA
YANLONG	GU	NA	NA
VERONIKA	FISCHER	NA	NA
YIN	LIU	NA	NA
QINMIN	PAN	NA	NA
GARRY	REMPEL	NA	NA
ANNE	WADOUACHI	NA	NA
STÉPHANIE	RAT	NA	NA
EMMANUEL	PETIT	NA	NA
PHILIPPE	MICHAUD	NA	NA
JOSÉ	KOVENSKY	NA	NA
J	ABDOUL-ZABAR	NA	NA
I	SOREL	NA	NA
V	HÉLAINE	NA	NA
F	CHARMANTRAY	NA	NA
T	DEVAMANI	NA	NA
D	YI	NA	NA
V DE	BERARDINIS	NA	NA
D	LOUIS	NA	NA
P	MARLIÈRE	NA	NA
W -D	FESSNER	NA	NA
L	HECQUET	NA	NA
LAURENT	ROUMEAS	NA	NA
CHAHINEZ	AOUF	NA	NA
ERIC	DUBREUCQ	NA	NA
HÉLÈNE	FULCRAND	NA	NA
MARKUS	HEINRICH	MARKUS R	HEINRICH
CRISTINA DE	SALAS	NA	NA
ALICE	MEULLEMIESTRE	NA	NA
SID-AHMED	REZZOUG	NA	NA
ZOULIKHA	REZZOUG	NA	NA
ALI	ASAFF	NA	NA
YOLANDA	REYES	NA	NA
ANGEL	ACEVES	NA	NA
JUAN CARLOS	MATEOS	NA	NA
HANA	KRIZOVA	NA	NA
VINCENT	ESCANDE	NA	NA
CLAUDE	GRISON	NA	NA
DINGYI	YU	NA	NA
YUGEN	ZHANG	NA	NA
ALESSANDRA	VIZZA	NA	NA
JEREMY	JORDA	NA	NA
DANIELA	LAVRIC	NA	NA
JEAN-RENÉ	CHÉROUVRIER	NA	NA
ROMAIN	REY-RODRIGUEZ	NA	NA
EMILIE	MARIE	NA	NA
MARIANNE	GRABER	NA	NA
VALÉRIE	THIÉRIE	NA	NA
P	ANASTAS	NA	NA
J F	MINSTER	NA	NA
B	SELS	NA	NA
P	MARION	NA	NA
A	BULEON	NA	NA
F	SCHÜTH	NA	NA
M	LERSCH	NA	NA
P	JESSOP	NA	NA
F	AULENTA	NA	NA
J	CLARK	NA	NA
T	ZHANG	NA	NA
S	REBOUILLAT	NA	NA
F DEL	MONTE	NA	NA
S	KOBAYASHI	NA	NA
P	MONSAN	NA	NA
S DUPRAT DE	PAULE	NA	NA
J L	DUBOIS	NA	NA
B	WECKHUYSEN	NA	NA
A	CORMA	NA	NA
S	MAURY	NA	NA
M	PHILIPPE	NA	NA
C J	LI	NA	NA
